#TV
0 0 0 0 2 2 3 3 3 5 6 5 6 6 7 7 12 13 11 9 11 8 8 12 15 11 11 9 11 11 12 9 6 1 2 0 
#Desk
0 0 0 0 1 5 7 5 9 10 8 11 11 8 9 7 8 7 7 7 7 7 7 8 8 8 8 6 7 6 6 7 7 12 11 9 
#Chair09
0 0 0 1 2 2 3 2 5 6 7 9 10 8 11 9 9 8 11 10 12 12 14 12 11 6 9 8 8 8 6 5 4 5 5 2 
#Chair08
0 0 1 0 1 3 2 2 3 7 9 7 8 11 8 10 10 9 9 12 10 13 12 12 11 8 9 9 10 5 5 5 5 5 3 1 
#Chair07
0 0 0 1 2 3 3 3 5 5 6 7 7 9 9 9 12 8 9 11 12 11 14 12 9 9 9 9 10 9 5 6 5 6 5 1 
#Chair06
0 0 0 1 1 2 3 3 5 5 7 7 10 9 8 11 10 9 8 11 13 13 15 15 10 6 8 8 11 8 5 4 4 5 5 2 
#Chair05
0 0 1 0 2 4 2 3 4 5 6 8 9 8 9 12 8 8 9 12 9 11 15 13 8 7 9 9 9 8 7 6 6 4 6 1 
#Chair04
0 0 0 0 1 3 3 3 4 8 6 6 9 8 11 10 9 8 10 9 12 12 15 12 10 8 8 10 12 9 6 5 4 4 5 2 
#Chair03
0 0 1 0 2 2 1 3 5 7 7 7 9 9 11 9 9 8 9 12 10 12 14 13 11 8 9 8 9 7 4 6 5 6 4 0 
#Chair02
0 0 1 0 2 4 3 4 4 6 6 6 10 10 8 10 11 10 7 11 10 12 15 11 9 9 7 10 10 8 5 4 4 5 5 2 
#Chair010
0 0 0 1 2 2 1 3 5 7 6 7 9 9 10 10 9 8 8 8 11 14 16 13 8 8 8 12 11 7 7 5 4 6 4 1 
#Chair01
0 0 1 1 1 1 3 2 5 6 7 9 8 9 9 9 9 9 11 11 12 12 13 13 13 8 7 8 7 8 6 6 5 6 3 2 
