#Desk
0 0 0 8 13 6 6 24 31 10 0 0 0 0 0 6 14 7 0 0 0 5 17 5 4 25 29 9 0 0 0 0 0 7 14 6 
#Chair09
0 0 0 4 3 6 1 23 55 12 1 0 0 0 0 6 5 11 0 0 0 5 7 8 0 19 55 10 1 0 0 0 0 5 2 7 
#Chair08
0 0 0 4 3 6 1 20 58 12 1 0 0 0 0 5 9 7 0 0 0 5 8 8 1 19 50 11 1 0 0 0 0 5 3 9 
#Chair07
0 0 0 4 3 7 2 18 55 12 1 0 0 0 0 5 6 10 0 0 0 3 9 9 1 22 54 11 1 0 0 0 0 3 3 6 
#Chair06
0 0 0 5 3 7 0 21 52 10 0 0 0 0 0 4 7 11 0 0 0 6 6 9 0 19 57 10 0 0 0 0 0 4 5 7 
#Chair05
0 0 0 4 5 6 1 22 54 11 1 0 0 0 0 5 9 9 0 0 0 4 7 7 0 18 55 13 0 0 0 0 0 4 2 6 
#Chair04
0 0 0 5 4 7 1 19 54 13 1 0 0 0 0 3 7 10 0 0 0 4 8 10 1 20 54 11 1 0 0 0 0 3 2 8 
#Chair03
0 0 0 3 4 8 1 19 49 12 0 0 0 0 0 5 7 10 0 0 0 5 7 10 1 22 52 12 0 0 0 0 0 6 3 7 
#Chair02
0 0 0 5 3 5 1 23 51 9 0 0 0 0 0 4 8 8 0 0 0 7 8 9 1 23 56 11 0 0 0 0 0 4 3 6 
#Chair010
0 0 0 6 3 8 2 20 52 11 1 0 0 0 0 4 7 7 0 0 0 6 8 9 1 18 55 12 1 0 0 0 0 4 3 7 
#Chair01
0 0 0 4 3 8 0 17 57 11 0 0 0 0 0 4 9 7 0 0 0 6 7 7 1 22 54 11 1 0 0 0 0 5 4 8 
