#Desk
15 41 53 49 37 26 17 11 3 0 
#Chair09
11 36 59 61 42 24 11 5 2 0 
#Chair08
11 36 57 61 44 25 12 5 2 0 
#Chair07
11 36 57 61 44 25 11 5 2 0 
#Chair06
11 35 56 61 43 26 12 6 2 0 
#Chair05
11 36 57 61 44 25 11 5 2 0 
#Chair04
11 35 56 61 43 26 12 5 2 0 
#Chair03
10 34 55 60 44 26 13 6 2 0 
#Chair02
12 38 59 60 42 24 10 5 2 0 
#Chair010
11 35 57 60 44 25 12 5 2 0 
#Chair01
11 35 57 62 44 25 11 5 2 0 
