#Desk
0 0 0 3 24 7 0 1 34 26 2 0 0 0 0 4 15 8 0 0 0 2 15 6 0 1 37 28 2 0 0 0 0 3 18 8 
#Chair08
0 0 0 2 1 3 3 16 34 30 11 2 0 0 0 4 9 11 0 0 0 4 10 8 2 16 30 33 7 1 0 0 0 3 1 4 
#Chair07
0 0 0 2 2 2 3 17 31 33 8 1 0 0 0 2 11 9 0 0 0 3 8 9 5 15 33 30 9 3 0 0 0 2 2 3 
#Chair06
0 0 0 3 2 2 3 16 32 32 8 3 0 0 0 2 12 9 0 0 0 4 11 8 2 15 29 33 9 3 0 0 0 3 2 2 
#Chair05
0 0 0 3 1 3 4 16 29 31 9 2 0 0 0 4 12 9 0 0 0 3 8 9 2 16 30 33 9 2 0 0 0 3 2 3 
#Chair04
0 0 0 3 3 4 3 15 28 33 8 1 0 0 0 3 10 8 0 0 0 3 12 8 4 17 32 33 7 2 0 0 0 3 2 3 
#Chair03
0 0 0 1 2 4 3 16 33 32 8 3 0 0 0 3 9 9 0 0 0 3 10 9 2 15 30 35 9 1 0 0 0 2 2 4 
#Chair02
0 0 0 4 2 3 3 19 29 31 7 3 0 0 0 3 12 7 0 0 0 3 10 8 3 20 33 28 8 3 0 0 0 3 1 3 
#Chair01
0 0 0 3 2 3 3 14 29 34 11 2 0 0 0 4 10 8 0 0 0 2 10 8 3 15 29 32 11 3 0 0 0 3 2 3 
