#Desk
0 0 0 12 8 10 8 10 13 14 11 10 8 9 11 0 0 0 0 0 0 10 9 7 11 12 11 11 11 12 9 7 11 0 0 0 
#Chair06
0 0 0 1 3 6 16 18 18 22 16 10 6 3 2 2 0 0 0 0 2 3 4 6 9 16 21 19 18 12 5 2 1 0 0 0 
#Chair05
0 0 1 1 2 5 14 19 19 20 16 9 5 4 3 1 0 0 0 0 2 4 4 7 9 14 20 21 21 12 3 3 2 1 0 0 
#Chair04
0 0 0 1 2 4 14 19 20 21 16 9 6 3 3 2 0 0 0 0 2 3 4 6 11 14 22 21 19 13 4 2 2 0 0 0 
#Chair03
0 0 1 2 2 6 14 18 19 20 15 9 7 3 3 2 0 0 0 0 1 2 4 6 11 13 19 18 18 12 8 4 1 0 0 0 
#Chair02
0 0 1 1 2 5 16 18 21 20 15 9 5 4 2 1 0 0 0 0 2 3 5 5 9 16 18 20 21 15 4 2 1 0 0 0 
#Chair01
0 0 1 2 2 3 11 17 18 25 16 9 5 3 3 2 0 0 0 0 2 2 4 7 10 19 23 21 21 10 2 1 2 0 0 0 
