#Desk
0 0 0 0 0 0 0 0 0 2 5 10 11 9 9 12 9 10 14 15 11 9 9 8 8 8 7 7 8 9 13 10 9 6 10 4 
#Chair06
0 0 0 0 2 2 3 3 5 6 5 7 10 10 12 13 12 9 10 10 9 8 11 9 10 9 8 11 13 10 8 6 4 3 3 1 
#Chair05
0 0 0 1 1 3 3 4 5 6 5 8 7 12 12 13 11 9 10 9 10 9 9 9 10 13 8 8 12 7 9 7 4 4 3 0 
#Chair04
0 0 0 1 2 3 4 3 4 4 5 6 7 11 11 12 11 10 10 9 11 10 9 10 9 13 8 9 11 11 9 6 5 4 2 1 
#Chair03
0 0 0 1 2 1 2 4 4 6 5 8 6 8 10 12 9 7 10 9 11 10 9 13 10 10 8 9 15 14 8 7 4 2 3 2 
#Chair02
0 0 0 1 2 2 2 3 5 5 6 6 7 10 10 10 11 11 9 9 10 9 13 11 12 9 8 11 10 12 8 7 4 3 2 1 
#Chair01
0 0 0 0 0 0 2 2 5 7 6 4 6 6 10 13 15 16 20 18 13 12 9 9 11 9 8 6 3 2 4 5 6 7 5 3 
