#Desk
0 0 0 2 2 3 3 3 4 5 6 6 6 6 6 8 8 6 6 6 6 5 13 18 19 19 19 14 9 7 7 5 5 3 1 0 
#Chair08
0 0 0 0 2 3 4 4 2 3 4 5 4 8 11 14 16 17 17 14 16 14 12 10 7 7 4 3 4 2 4 8 6 7 6 1 
#Chair07
0 0 0 0 1 3 3 3 4 5 4 6 6 8 9 12 14 15 15 14 14 14 15 11 8 7 5 4 6 3 3 5 8 6 4 2 
#Chair06
0 0 0 1 1 2 4 4 4 3 5 5 7 6 10 14 15 16 15 15 13 13 15 10 7 6 6 4 5 3 3 7 9 7 4 1 
#Chair05
0 0 0 1 2 2 4 4 3 4 5 5 4 7 12 14 15 14 13 15 15 10 15 10 7 6 6 4 4 3 4 6 10 8 5 2 
#Chair04
0 0 0 1 2 2 3 4 3 5 4 5 6 9 10 14 14 15 13 14 11 15 12 11 8 6 5 5 3 4 3 7 8 7 6 1 
#Chair03
0 0 0 1 1 4 4 4 4 4 4 4 6 8 10 14 16 14 12 15 14 12 12 12 9 7 5 4 4 4 4 6 9 8 6 2 
#Chair02
0 0 0 0 2 2 2 4 5 5 4 4 6 7 10 15 16 16 12 15 12 12 14 13 7 5 6 4 4 6 4 5 9 7 6 1 
#Chair01
0 0 0 1 2 3 5 4 4 4 5 6 6 8 8 13 15 17 12 12 18 13 12 12 7 5 5 4 5 4 4 8 8 7 5 1 
