#Desk
0 0 0 11 21 6 5 13 21 7 0 0 0 0 0 11 23 6 0 0 0 9 21 7 4 15 21 6 0 0 0 0 0 10 24 5 
#Chair08
0 0 0 3 2 6 2 11 38 34 2 5 0 0 0 6 9 4 0 0 0 5 9 6 4 13 34 36 4 5 0 0 0 0 0 4 
#Chair07
0 0 0 2 2 6 2 13 34 38 3 5 0 0 0 5 12 4 0 0 0 5 11 5 3 15 31 33 4 4 0 0 0 1 0 5 
#Chair06
0 0 0 3 2 5 3 14 35 35 4 7 0 0 0 4 9 5 0 0 0 6 12 5 2 13 34 33 4 6 0 0 0 1 1 4 
#Chair05
0 0 0 1 3 5 3 15 35 33 3 8 0 0 0 6 10 6 0 0 0 6 10 6 3 13 33 32 3 4 0 0 0 2 0 6 
#Chair04
0 0 0 1 2 5 2 14 39 34 3 5 0 0 0 6 11 4 0 0 0 4 11 7 3 13 32 30 4 8 0 0 0 1 1 6 
#Chair03
0 0 0 1 2 6 3 11 35 32 4 7 0 0 0 5 8 4 0 0 0 5 12 6 3 15 34 33 4 6 0 0 0 1 1 5 
#Chair02
0 0 0 1 2 4 2 13 37 31 2 6 0 0 0 4 11 4 0 0 0 5 12 7 3 14 34 36 3 5 0 0 0 0 1 6 
#Chair01
0 0 0 2 1 5 3 17 35 35 3 6 0 0 0 3 8 6 0 0 0 5 13 6 2 13 33 32 3 6 0 0 0 0 1 4 
