#TV
0 0 0 5 16 5 4 11 24 31 12 0 0 0 0 5 13 5 0 0 0 6 12 6 4 17 28 16 0 0 0 0 0 5 13 7 
#Desk
0 0 0 12 11 6 11 24 25 4 0 0 0 0 0 12 12 7 0 0 0 12 12 6 12 28 21 2 0 0 0 0 0 13 11 5 
#Chair09
0 0 0 2 11 5 4 14 24 21 4 0 0 0 0 8 12 17 0 0 0 6 14 18 6 16 19 18 7 0 0 0 0 2 9 7 
#Chair08
0 0 0 2 11 5 4 14 23 20 4 0 0 0 0 8 12 17 0 0 0 7 14 18 6 15 20 18 7 0 0 0 0 3 9 7 
#Chair07
0 0 0 1 11 7 5 11 23 20 7 0 0 0 0 8 13 18 0 0 0 8 15 20 4 13 18 21 7 0 0 0 0 2 9 5 
#Chair06
0 0 0 3 11 6 6 13 23 18 8 0 0 0 0 8 11 18 0 0 0 10 14 21 5 11 18 19 6 0 0 0 0 2 8 8 
#Chair05
0 0 0 2 11 7 4 12 22 19 6 0 0 0 0 8 12 18 0 0 0 6 13 19 5 14 22 22 5 0 0 0 0 1 10 6 
#Chair04
0 0 0 2 11 7 4 13 22 20 6 0 0 0 0 8 12 18 0 0 0 6 13 18 5 14 23 22 5 0 0 0 0 1 9 6 
#Chair03
0 0 0 2 12 7 4 11 22 20 7 0 0 0 0 10 13 16 0 0 0 9 14 16 6 14 19 17 8 0 0 0 0 3 10 6 
#Chair02
0 0 0 3 10 7 5 15 21 16 8 0 0 0 0 9 14 16 0 0 0 9 13 17 3 11 22 20 7 0 0 0 0 2 10 7 
#Chair014
0 0 0 2 10 7 3 12 22 20 7 0 0 0 0 10 12 18 0 0 0 9 13 16 5 15 20 16 8 0 0 0 0 3 10 7 
#Chair013
0 0 0 2 10 6 6 12 22 22 6 0 0 0 0 7 13 17 0 0 0 8 13 18 3 14 21 21 7 0 0 0 0 2 9 6 
#Chair012
0 0 0 2 10 7 6 14 18 20 6 0 0 0 0 8 14 18 0 0 0 9 13 17 5 14 23 19 7 0 0 0 0 2 7 6 
#Chair011
0 0 0 2 9 7 5 14 19 20 6 0 0 0 0 8 14 17 0 0 0 9 12 18 5 14 23 20 7 0 0 0 0 2 7 6 
#Chair010
0 0 0 2 9 7 5 12 19 20 6 0 0 0 0 10 12 18 0 0 0 10 13 17 6 12 20 20 7 0 0 0 0 3 10 7 
#Chair01
0 0 0 3 11 8 4 12 21 20 6 0 0 0 0 10 11 18 0 0 0 10 11 19 5 12 20 20 6 0 0 0 0 3 9 6 
#Carpet
0 0 0 7 11 7 6 20 31 12 0 0 0 0 0 8 12 6 0 0 0 8 13 8 5 20 32 12 0 0 0 0 0 7 13 9 
