#TV
13 33 43 49 46 33 20 11 3 0 
#Desk
22 55 50 39 30 23 18 11 3 0 
#Chair09
9 23 40 55 53 36 19 12 4 0 
#Chair08
9 23 40 54 53 36 20 12 4 0 
#Chair07
9 21 39 53 54 38 21 12 4 0 
#Chair06
9 22 38 53 53 37 21 13 5 0 
#Chair05
9 22 40 53 54 37 20 12 4 0 
#Chair04
9 22 40 54 54 37 20 11 4 0 
#Chair03
9 23 39 53 52 37 22 13 4 0 
#Chair02
9 23 39 53 52 37 21 13 4 0 
#Chair014
9 22 39 53 52 37 21 13 4 0 
#Chair013
9 22 39 53 54 37 20 12 4 0 
#Chair012
9 23 40 53 54 36 20 12 4 0 
#Chair011
9 23 40 53 54 37 20 12 4 0 
#Chair010
9 23 40 53 52 36 21 13 4 0 
#Chair01
9 22 38 53 53 37 21 13 5 1 
#Carpet
16 40 50 48 37 27 18 11 4 0 
