#TV
0 1 1 1 2 2 2 3 4 6 5 6 7 8 8 9 9 9 12 9 11 13 12 11 11 13 12 9 11 10 9 6 3 2 1 1 
#Desk
0 1 4 6 6 6 8 7 8 8 10 9 7 7 7 9 8 5 7 7 9 12 11 10 10 11 8 5 4 6 5 4 4 4 3 1 
#Chair09
0 1 1 1 3 3 3 5 5 3 5 6 5 7 6 6 8 9 8 8 10 12 9 11 14 12 10 7 6 8 8 8 8 7 7 8 
#Chair08
0 1 1 2 3 2 3 5 5 4 5 6 5 7 6 6 8 9 8 8 9 12 10 11 13 12 10 7 7 9 8 7 8 7 7 9 
#Chair07
0 1 2 1 1 2 2 3 3 6 4 5 5 6 6 8 7 8 10 11 8 11 9 11 14 12 11 9 7 8 10 6 9 8 9 7 
#Chair06
0 1 1 1 2 3 3 2 3 6 4 5 6 6 8 7 5 7 8 9 10 10 10 13 13 14 8 7 6 8 8 8 11 8 10 8 
#Chair05
0 1 0 2 2 2 3 3 3 5 5 5 5 6 6 8 7 10 10 9 10 12 9 10 11 12 10 9 7 7 9 9 9 9 8 6 
#Chair04
0 1 1 2 2 2 3 4 4 5 5 5 5 7 6 8 7 10 9 10 9 12 9 9 11 12 9 9 7 8 9 9 8 9 8 5 
#Chair03
0 1 1 1 2 3 3 3 3 4 5 4 6 5 7 7 7 8 8 9 9 10 12 14 16 10 12 10 9 7 9 7 7 7 8 6 
#Chair02
0 1 1 1 2 2 3 3 3 4 5 5 6 7 6 7 7 9 8 8 8 11 12 12 15 11 11 9 8 7 9 6 8 8 8 7 
#Chair014
0 1 1 1 2 2 3 4 3 4 5 6 6 6 6 7 7 9 8 8 9 11 13 12 15 11 10 9 9 6 9 7 9 8 8 7 
#Chair013
0 1 2 1 2 2 4 3 4 4 4 5 6 6 6 7 7 9 11 9 8 11 10 13 14 11 11 8 8 8 8 7 7 10 9 5 
#Chair012
0 1 1 1 2 4 3 2 4 4 4 7 7 6 6 7 7 6 10 7 9 11 10 13 14 12 9 9 7 6 9 6 9 7 9 6 
#Chair011
0 1 1 1 2 3 3 3 4 5 4 8 6 6 7 6 7 7 11 8 8 11 10 13 14 12 9 8 7 5 10 7 8 7 9 5 
#Chair010
0 1 1 1 3 3 2 2 4 5 3 6 6 6 6 6 7 7 10 8 11 12 10 13 14 12 9 8 6 7 9 7 9 6 10 7 
#Chair01
0 1 1 2 1 3 3 2 4 5 3 4 6 6 7 6 7 7 9 10 11 12 10 14 11 11 10 8 7 7 8 8 9 7 10 8 
#Carpet
0 0 1 2 3 3 4 6 7 4 7 10 9 9 12 10 11 9 9 11 10 8 9 8 7 8 8 9 8 8 9 8 5 4 2 0 
