#TV
0 0 0 6 8 12 13 14 14 14 14 13 11 8 5 0 0 0 0 0 0 6 8 10 9 9 12 13 12 9 9 8 8 0 0 0 
#Desk
0 1 3 4 9 12 9 9 13 11 9 12 12 9 3 3 1 0 0 2 2 5 9 12 9 8 14 12 12 7 13 7 5 2 0 0 
#Chair09
0 0 2 2 6 7 6 6 32 16 2 4 19 11 6 1 0 0 0 1 1 5 12 19 3 2 14 31 8 7 7 5 4 3 0 0 
#Chair08
0 0 2 2 6 7 6 5 32 16 2 4 18 11 6 1 0 0 0 1 1 6 12 19 3 2 14 31 8 8 7 5 4 3 0 0 
#Chair07
0 0 2 4 6 7 6 8 30 17 1 2 18 12 6 1 0 0 0 1 2 6 12 22 4 2 12 29 8 8 5 6 2 2 0 0 
#Chair06
0 0 2 2 6 8 6 10 29 17 2 3 19 12 5 1 0 0 0 1 3 5 12 23 3 1 13 28 5 7 6 5 3 3 0 0 
#Chair05
0 0 2 3 7 8 6 8 28 15 2 4 18 11 6 2 0 0 0 0 2 6 12 16 3 2 14 36 8 7 5 7 3 2 0 0 
#Chair04
0 0 2 3 7 8 6 8 30 15 2 4 18 11 6 2 0 0 0 0 2 5 12 16 3 2 14 36 8 6 6 6 3 1 0 0 
#Chair03
0 0 2 4 7 8 7 9 29 14 2 3 21 11 5 1 0 0 0 0 1 5 12 19 3 1 12 30 10 7 8 6 2 3 0 0 
#Chair02
0 0 3 3 6 7 6 10 32 12 2 3 20 11 6 1 0 0 0 0 1 5 11 21 3 2 14 27 9 7 6 7 4 2 0 0 
#Chair014
0 0 2 4 7 6 7 9 27 14 2 3 21 10 6 1 0 0 0 0 1 6 11 20 3 2 12 31 10 6 7 7 2 3 0 0 
#Chair013
0 0 3 3 6 6 6 8 30 16 2 4 19 10 7 1 0 0 0 0 2 6 11 20 3 2 16 29 9 7 5 6 3 3 0 0 
#Chair012
0 0 2 3 7 7 8 7 28 15 2 2 20 11 7 1 0 0 0 0 0 7 11 21 2 3 15 32 10 6 5 5 3 2 0 0 
#Chair011
0 0 2 3 6 6 8 8 29 15 3 2 19 12 6 1 0 0 0 0 0 7 10 21 2 3 15 32 10 7 6 5 3 2 0 0 
#Chair010
0 0 2 4 6 7 8 7 30 13 1 2 21 10 6 1 0 0 0 0 1 5 12 20 3 2 13 31 8 8 7 6 2 3 0 0 
#Chair01
0 0 3 4 7 8 7 8 28 14 2 3 20 10 6 2 0 0 0 0 1 6 12 19 4 1 15 28 8 6 7 6 3 3 0 0 
#Carpet
0 0 1 6 8 9 11 12 12 11 11 10 10 8 6 0 0 0 0 0 2 8 9 10 10 12 12 10 12 12 10 8 8 1 0 0 
