#Desk
0 0 1 8 11 11 10 10 9 11 10 11 8 9 10 1 0 0 0 0 0 9 14 11 8 12 9 10 12 9 8 10 9 1 0 0 
#Chair09
0 0 1 0 2 4 11 29 24 14 12 7 5 8 4 5 0 0 0 0 4 4 8 5 6 13 11 20 29 8 3 2 1 0 0 0 
#Chair08
0 0 0 0 2 4 9 29 23 12 12 10 4 9 3 4 0 0 0 0 3 4 9 5 6 13 13 23 31 8 4 1 0 0 0 0 
#Chair07
0 0 1 0 2 4 8 24 27 12 14 8 6 7 4 4 0 0 0 0 3 4 9 6 7 11 12 24 29 9 5 1 1 0 0 0 
#Chair06
0 0 0 0 2 4 8 30 22 12 12 8 5 7 5 3 0 0 0 0 3 5 8 3 10 11 13 25 28 9 4 2 0 0 0 0 
#Chair05
0 0 0 1 1 4 8 29 22 14 13 9 7 10 3 3 0 0 0 0 4 5 8 5 8 13 11 24 25 9 4 2 0 0 0 0 
#Chair04
0 0 0 1 2 4 7 26 24 12 12 9 5 9 4 2 0 0 0 0 3 4 9 4 8 11 12 23 34 9 5 2 0 0 0 0 
#Chair03
0 0 0 0 2 3 6 30 24 11 14 9 5 8 4 4 0 0 0 0 4 4 9 5 9 13 12 22 28 8 4 2 0 0 0 0 
#Chair02
0 0 1 0 2 5 9 26 21 14 12 9 6 8 5 3 0 0 0 0 4 3 7 5 9 14 12 25 25 9 5 2 1 0 0 0 
#Chair012
0 0 0 1 2 6 9 25 24 14 11 9 5 8 4 4 0 0 0 0 3 5 7 5 7 12 13 24 29 9 4 2 0 0 0 0 
#Chair011
0 0 0 1 1 4 9 26 22 13 12 7 7 8 4 4 0 0 0 0 3 4 7 5 8 13 12 27 26 9 5 2 0 0 0 0 
#Chair010
0 0 0 1 3 4 10 26 24 14 14 10 6 7 6 3 0 0 0 0 4 4 8 4 8 11 14 21 27 8 4 1 0 0 0 0 
#Chair01
0 0 0 1 2 3 9 26 24 13 13 7 6 10 5 3 0 0 0 0 5 6 9 5 8 13 11 22 26 10 4 2 1 0 0 0 
#Bookshelf
0 0 6 4 7 6 7 18 11 11 19 7 5 5 6 5 0 0 0 0 5 6 7 8 8 20 14 11 18 10 7 5 3 4 0 0 
