#Desk
0 0 0 0 0 0 3 4 4 4 6 8 9 10 8 9 11 12 12 7 7 7 9 8 9 8 6 7 12 11 11 10 10 9 6 4 
#Chair09
0 0 0 0 1 1 3 4 4 6 12 12 11 12 11 11 16 18 16 16 10 8 8 7 7 9 5 3 4 3 3 3 5 7 4 2 
#Chair08
0 0 0 0 0 1 2 5 4 5 13 14 10 15 12 12 17 17 16 15 11 8 6 8 7 7 4 4 4 3 3 3 4 6 2 1 
#Chair07
0 0 0 1 0 0 3 5 6 7 11 10 10 14 13 13 17 17 15 17 9 5 7 8 8 8 7 4 2 3 3 2 3 7 4 1 
#Chair06
0 0 0 0 0 0 2 6 5 6 10 11 11 13 12 14 17 18 17 16 9 8 7 8 6 7 7 3 3 2 3 3 5 7 3 2 
#Chair05
0 0 0 0 0 0 2 5 5 7 11 11 12 11 13 15 15 15 17 17 11 6 6 7 7 7 6 4 4 3 3 2 4 7 3 2 
#Chair04
0 0 0 0 0 1 3 4 6 7 12 12 10 16 14 12 15 16 15 13 10 6 8 7 7 9 7 4 2 3 3 3 5 6 3 1 
#Chair03
0 0 0 0 0 0 3 5 5 7 12 10 9 14 13 14 17 17 15 14 11 6 8 6 7 8 6 3 3 3 2 3 5 7 4 1 
#Chair02
0 0 0 0 0 1 1 6 4 8 12 11 10 10 13 12 16 18 16 13 9 7 7 8 8 7 7 2 3 3 3 4 4 7 4 2 
#Chair012
0 0 0 0 0 1 3 4 4 7 12 11 12 11 13 12 15 17 16 14 11 8 6 8 9 7 4 5 4 2 3 3 4 8 4 2 
#Chair011
0 0 0 1 0 0 1 4 5 7 12 12 13 13 9 13 18 19 12 16 8 8 5 8 7 8 7 4 3 3 2 4 6 5 2 3 
#Chair010
0 0 0 0 1 1 3 4 6 8 12 11 12 11 13 11 17 17 16 14 9 9 7 7 6 8 4 3 3 3 4 4 5 6 4 1 
#Chair01
0 0 0 0 0 1 2 5 6 8 11 11 10 13 12 12 15 16 13 15 10 7 6 8 8 7 7 3 3 4 3 4 5 8 3 2 
#Bookshelf
0 0 0 0 0 3 4 6 6 7 8 13 11 9 9 15 17 13 10 7 7 7 7 7 6 6 5 6 5 7 5 9 10 7 6 2 
