#TV
0 0 0 5 16 9 4 16 25 20 1 0 0 0 0 5 13 9 0 0 0 5 15 11 1 17 28 19 1 0 0 0 0 5 13 7 
#Desk
0 0 0 4 7 12 5 24 25 7 0 0 0 0 0 6 14 11 0 0 0 8 15 14 3 28 31 8 0 0 0 0 0 6 7 11 
#Chair09
0 0 0 2 9 1 1 22 63 11 0 0 0 0 0 2 5 7 0 0 0 3 3 8 1 21 59 10 0 0 0 0 0 2 11 3 
#Chair08
0 0 0 2 9 2 1 22 59 12 0 0 0 0 0 3 5 6 0 0 0 3 5 8 2 21 56 12 0 0 0 0 0 3 11 2 
#Chair07
0 0 0 3 10 4 1 21 62 11 0 0 0 0 0 2 6 7 0 0 0 2 6 7 1 18 58 10 0 0 0 0 0 3 10 3 
#Chair06
0 0 0 2 10 3 1 24 63 8 0 0 0 0 0 2 6 8 0 0 0 2 5 7 2 18 57 9 0 0 0 0 0 4 11 3 
#Chair05
0 0 0 2 9 4 2 16 59 12 0 0 0 0 0 3 5 6 0 0 0 3 5 9 1 20 59 12 0 0 0 0 0 3 11 3 
#Chair04
0 0 0 2 9 2 2 20 60 8 0 0 0 0 0 4 6 7 0 0 0 2 5 7 1 19 59 14 0 0 0 0 0 4 12 2 
#Chair03
0 0 0 2 10 2 1 21 60 10 0 1 0 0 0 1 4 8 0 0 0 2 6 7 1 19 62 12 0 0 0 0 0 3 9 3 
#Chair02
0 0 0 3 9 3 1 23 59 9 0 1 0 0 0 3 6 7 0 0 0 3 5 7 1 18 61 12 0 0 0 0 0 2 10 2 
#Chair010
0 0 0 2 10 2 1 21 61 11 0 0 0 0 0 4 5 8 0 0 0 1 5 8 2 19 60 11 0 0 0 0 0 3 10 2 
#Chair01
0 0 0 3 8 2 2 21 57 9 0 0 0 0 0 3 5 8 0 0 0 2 6 8 1 24 59 13 0 0 0 0 0 3 9 3 
#Cabinet
0 0 0 7 10 18 0 11 41 21 0 0 0 0 0 6 13 20 0 0 0 5 7 17 0 13 22 11 0 0 0 0 0 5 7 14 
#Bonsai02
0 0 0 7 8 0 17 38 29 3 0 0 0 0 0 8 36 38 0 0 0 0 14 17 5 7 4 0 0 0 0 0 0 7 8 2 
#Bonsai01
0 0 0 6 8 0 17 37 30 3 0 0 0 0 0 9 37 38 0 0 0 0 13 16 4 7 4 0 0 0 0 0 0 7 9 2 
