#WaterFountain
0 0 0 0 1 1 3 12 17 16 13 14 27 9 6 8 7 7 4 5 5 5 6 5 5 5 6 5 5 4 6 4 5 5 4 15 
#Screen02
0 0 0 1 2 2 2 3 3 3 3 3 4 5 6 6 8 14 15 10 8 10 9 7 9 8 8 7 9 13 18 17 10 9 5 2 
#Screen01
0 0 1 1 1 2 2 2 2 3 4 3 4 4 7 6 8 14 14 9 9 9 9 7 8 8 9 8 8 16 16 14 13 8 7 1 
#Desk
0 1 1 2 4 6 8 8 9 9 10 9 9 10 11 8 7 11 10 8 8 10 10 7 8 9 10 7 8 5 4 2 3 4 3 1 
#Chair09
0 1 1 2 2 3 3 4 3 2 4 4 5 4 6 8 8 10 11 9 12 11 8 8 12 10 8 9 8 7 10 6 10 10 9 8 
#Chair08
0 1 1 2 2 3 3 5 2 2 4 4 5 4 7 8 8 10 11 9 12 11 8 8 12 10 8 9 8 7 10 7 10 10 9 8 
#Chair07
0 1 1 2 2 2 3 3 3 4 4 5 5 5 7 8 9 8 12 9 11 10 7 11 10 10 9 8 6 7 10 8 10 10 11 8 
#Chair06
0 1 1 2 2 2 3 2 5 4 3 6 5 6 6 6 7 7 11 9 10 9 8 11 10 9 10 6 8 9 10 10 10 10 10 10 
#Chair05
0 1 1 2 1 3 3 2 3 3 3 6 4 5 8 8 7 8 9 10 11 9 6 12 12 10 10 8 7 9 10 10 8 9 12 8 
#Chair04
0 1 1 2 1 3 3 2 3 3 4 6 4 5 8 8 8 8 9 10 11 9 6 12 12 10 11 7 7 10 10 10 8 9 12 8 
#Chair03
0 1 1 1 2 2 3 3 3 4 4 6 6 6 6 8 7 9 9 8 10 7 9 10 12 10 9 8 6 8 11 10 10 8 10 9 
#Chair02
0 1 1 1 2 2 3 3 3 5 5 6 5 6 7 8 7 10 10 8 10 7 9 11 13 10 8 9 6 8 11 10 11 8 9 9 
#Chair012
0 0 1 2 3 2 2 3 3 5 4 5 7 7 7 7 7 7 11 8 10 10 10 9 11 10 8 8 9 9 9 8 10 7 11 8 
#Chair011
0 0 0 2 3 2 2 3 3 5 4 6 7 7 6 7 7 7 12 9 10 10 9 9 12 10 8 8 9 9 9 8 9 7 11 8 
#Chair010
0 1 2 1 3 3 3 3 4 4 4 5 6 6 7 6 6 11 10 8 12 8 8 10 10 10 9 7 9 8 10 8 8 12 10 8 
#Chair01
0 1 1 2 1 2 2 4 3 4 4 7 6 4 7 7 7 8 11 12 13 8 7 9 13 9 9 8 7 8 10 10 9 8 11 8 
#CellingLight03
0 0 0 1 1 1 2 2 2 2 4 4 5 5 5 4 5 7 5 5 7 7 8 10 9 8 11 11 11 10 17 25 12 4 16 16 
#CellingLight02
0 0 0 0 1 1 3 2 4 3 2 4 3 4 4 5 5 4 5 6 5 5 8 7 12 9 11 10 15 16 15 24 12 7 14 16 
#CellingLight01
2 6 5 2 5 6 9 11 9 10 7 4 4 3 3 3 4 5 3 4 3 4 3 3 2 4 3 5 11 21 20 15 16 13 4 4 
#Cabinet
0 0 0 0 0 0 0 1 3 6 5 6 7 11 14 15 9 10 9 11 8 9 7 10 8 8 7 6 6 7 6 8 18 15 10 2 
#Bonsai03
0 0 0 1 0 0 2 2 2 2 2 2 1 3 3 5 7 6 7 7 8 8 5 9 9 6 6 5 7 9 12 15 25 24 21 19 
#Bonsai02
0 0 0 0 0 0 0 0 0 0 0 0 0 10 13 22 15 12 12 13 13 12 18 15 9 8 8 8 10 6 7 10 6 5 6 6 
#Bonsai01
0 0 0 0 0 0 0 0 0 0 0 1 1 2 4 3 3 4 3 4 4 7 11 23 29 37 25 16 13 9 8 9 7 7 10 4 
