#WaterFountain
0 0 0 4 8 13 2 50 38 4 0 0 0 0 0 7 8 7 0 0 0 7 9 11 0 28 28 4 0 0 0 0 0 5 4 9 
#Screen02
0 0 0 4 12 17 3 10 25 22 2 0 0 0 0 3 12 16 0 0 0 4 16 15 3 10 20 24 2 0 0 0 0 3 11 14 
#Screen01
0 0 0 3 16 15 3 8 23 20 1 0 0 0 0 3 11 15 0 0 0 3 14 16 3 10 22 25 1 0 0 0 0 4 14 15 
#Desk
0 0 0 7 11 3 8 27 30 10 0 0 0 0 0 7 13 4 0 0 0 9 11 5 6 28 28 11 0 0 0 0 0 7 13 5 
#Chair09
0 0 0 7 15 18 6 11 22 19 3 0 0 0 0 3 11 8 0 0 0 3 10 8 5 12 22 21 2 1 0 0 0 8 13 19 
#Chair08
0 0 0 8 15 18 6 11 22 18 3 0 0 0 0 3 11 8 0 0 0 3 10 7 5 12 22 21 2 1 0 0 0 7 13 20 
#Chair07
0 0 0 10 13 18 4 12 24 18 2 0 0 0 0 4 10 8 0 0 0 3 11 8 5 12 21 19 2 0 0 0 0 7 13 21 
#Chair06
0 0 0 8 13 22 5 12 18 17 1 0 0 0 0 4 12 8 0 0 0 3 10 9 6 14 20 18 2 0 0 0 0 8 13 21 
#Chair05
0 0 0 9 13 21 5 11 21 18 2 0 0 0 0 3 12 7 0 0 0 4 12 7 6 11 21 13 2 0 0 0 0 8 15 21 
#Chair04
0 0 0 9 13 21 5 11 22 18 2 0 0 0 0 3 12 7 0 0 0 3 12 7 5 11 20 14 2 0 0 0 0 8 15 20 
#Chair03
0 0 0 8 12 19 4 13 20 16 2 0 0 0 0 4 11 9 0 0 0 4 13 8 5 13 24 16 3 0 0 0 0 7 13 23 
#Chair02
0 0 0 7 12 19 4 13 21 16 1 0 0 0 0 4 11 9 0 0 0 3 14 8 5 13 23 16 3 0 0 0 0 7 12 22 
#Chair012
0 0 0 8 15 19 5 12 21 18 2 0 0 0 0 3 9 6 0 0 0 2 13 7 5 12 22 19 3 0 0 0 0 8 13 20 
#Chair011
0 0 0 8 15 18 5 12 22 19 2 0 0 0 0 3 10 6 0 0 0 2 13 8 5 14 22 19 3 0 0 0 0 8 14 20 
#Chair010
0 0 0 9 12 20 6 12 23 16 2 0 0 0 0 3 12 8 0 0 0 3 11 8 5 13 20 15 2 0 0 0 0 9 15 20 
#Chair01
0 0 0 8 16 20 5 13 21 21 2 0 0 0 0 3 9 7 0 0 0 3 10 9 4 13 20 16 3 0 0 0 0 8 14 20 
#CellingLight03
0 0 0 2 8 15 2 9 15 15 18 16 0 0 0 2 7 14 0 0 0 3 7 13 2 9 16 16 14 15 0 0 0 2 6 16 
#CellingLight02
0 0 0 2 8 13 1 9 13 12 18 16 0 0 0 2 8 15 0 0 0 3 10 15 2 10 14 13 22 17 0 0 0 3 7 11 
#CellingLight01
0 0 0 4 19 30 17 40 11 0 0 0 0 0 0 5 18 31 0 0 0 6 6 7 11 13 13 0 0 0 0 0 0 5 6 5 
#Cabinet
0 0 0 5 9 15 0 14 27 13 0 0 0 0 0 4 8 14 0 0 0 5 11 16 0 8 41 23 0 0 0 0 0 4 14 15 
#Bonsai03
0 0 0 4 5 5 2 7 18 24 18 26 0 0 0 0 2 26 0 0 0 0 0 22 1 5 9 14 11 31 0 0 0 2 6 5 
#Bonsai02
0 0 0 14 15 13 0 0 37 21 0 0 0 0 0 5 8 8 0 0 0 3 10 8 0 0 37 31 0 0 0 0 0 10 17 11 
#Bonsai01
0 0 0 5 10 7 0 1 10 24 43 0 0 0 0 0 7 14 0 0 0 0 10 17 0 0 9 18 49 0 0 0 0 6 10 9 
