#TV
0 0 0 4 14 7 2 11 30 16 1 0 0 0 0 5 15 8 0 0 0 5 14 7 3 18 34 16 0 0 0 0 0 8 16 7 
#Speaker02
0 0 0 0 14 11 0 0 9 35 23 0 0 0 0 4 17 11 0 0 0 3 17 10 0 0 10 36 24 0 0 0 0 0 12 9 
#Speaker01
0 0 0 0 13 14 0 0 9 37 22 0 0 0 0 3 21 11 0 0 0 3 13 10 0 0 9 33 21 0 0 0 0 0 14 14 
#Desk
0 0 0 12 11 6 12 27 23 3 0 0 0 0 0 11 13 6 0 0 0 10 15 7 13 24 22 4 0 0 0 0 0 10 13 6 
#Chair09
0 0 0 2 9 7 3 15 21 21 5 0 0 0 0 9 14 18 0 0 0 9 13 18 4 13 19 18 7 0 0 0 0 3 10 8 
#Chair08
0 0 0 2 11 6 5 14 18 19 5 0 0 0 0 9 14 19 0 0 0 7 13 18 6 11 21 20 7 0 0 0 0 2 10 8 
#Chair07
0 0 0 9 14 19 5 14 18 19 5 0 0 0 0 3 11 5 0 0 0 2 10 8 5 12 21 21 7 0 0 0 0 7 13 18 
#Chair06
0 0 0 9 11 20 5 14 19 21 6 0 0 0 0 2 10 6 0 0 0 2 9 7 4 14 22 22 6 0 0 0 0 8 12 16 
#Chair05
0 0 0 7 13 19 5 12 23 23 4 0 0 0 0 3 10 6 0 0 0 2 11 6 4 11 21 19 7 0 0 0 0 9 13 18 
#Chair04
0 0 0 7 13 18 5 12 22 23 4 0 0 0 0 2 10 6 0 0 0 2 11 7 4 11 21 19 7 0 0 0 0 9 14 18 
#Chair03
0 0 0 11 14 18 6 14 22 19 6 0 0 0 0 2 10 9 0 0 0 1 10 6 4 12 19 21 6 0 0 0 0 7 13 16 
#Chair02
0 0 0 11 13 17 6 14 22 19 5 0 0 0 0 2 10 9 0 0 0 1 10 7 4 12 19 22 6 0 0 0 0 7 12 16 
#Chair014
0 0 0 1 9 7 5 12 20 20 7 0 0 0 0 9 14 20 0 0 0 8 13 19 4 13 20 19 7 0 0 0 0 2 10 7 
#Chair013
0 0 0 1 9 8 5 12 20 20 7 0 0 0 0 9 14 20 0 0 0 8 13 19 4 13 20 19 6 0 0 0 0 2 10 7 
#Chair012
0 0 0 1 10 6 5 14 23 17 6 0 0 0 0 9 13 18 0 0 0 9 13 17 5 11 20 22 6 0 0 0 0 1 9 8 
#Chair011
0 0 0 1 10 7 5 14 23 17 6 0 0 0 0 9 13 18 0 0 0 10 14 17 5 11 20 22 6 0 0 0 0 1 9 8 
#Chair010
0 0 0 2 11 7 5 14 20 22 7 0 0 0 0 11 14 18 0 0 0 7 11 16 4 13 20 19 7 0 0 0 0 1 10 7 
#Chair01
0 0 0 2 9 6 3 15 21 20 5 0 0 0 0 8 12 19 0 0 0 8 13 18 7 17 19 18 7 0 0 0 0 2 10 7 
#Carpet
0 0 0 7 12 8 6 22 32 11 0 0 0 0 0 8 15 6 0 0 0 8 11 8 6 18 33 11 0 0 0 0 0 6 15 5 
