#TV
0 0 0 7 10 9 9 8 10 11 12 11 8 11 9 0 0 0 0 0 0 8 10 9 10 12 13 11 14 11 13 11 7 0 0 0 
#Speaker02
0 0 0 0 16 10 10 9 10 11 13 14 13 20 0 0 0 0 0 0 0 0 19 11 15 11 11 10 12 10 6 15 0 0 0 0 
#Speaker01
0 0 0 0 19 8 9 12 10 12 12 13 15 20 0 0 0 0 0 0 0 0 17 10 13 11 9 10 8 11 9 19 0 0 0 0 
#Desk
0 1 3 4 9 12 8 9 12 13 12 9 12 9 4 2 1 0 0 1 3 4 12 10 7 8 14 13 10 11 9 11 3 3 1 0 
#Chair09
0 0 3 3 6 7 6 8 32 14 2 3 20 12 7 1 1 0 0 0 0 7 12 19 3 1 13 28 8 7 8 6 3 3 0 0 
#Chair08
0 0 2 3 7 6 7 6 29 15 2 2 22 11 7 1 0 0 0 1 1 5 11 19 2 2 14 30 9 7 7 6 4 3 0 0 
#Chair07
0 0 1 7 12 21 2 2 15 28 7 8 7 6 3 2 0 0 0 0 3 4 6 6 7 10 29 14 2 2 19 11 5 2 1 0 
#Chair06
0 0 1 8 9 21 3 2 15 30 8 7 6 7 3 2 0 0 0 0 2 4 6 6 8 7 32 16 2 2 18 10 6 1 0 0 
#Chair05
0 0 1 6 12 18 2 2 16 30 7 8 8 5 2 2 0 0 0 0 2 3 7 7 7 8 29 13 2 2 21 12 5 2 0 0 
#Chair04
0 0 1 6 12 19 2 2 15 30 7 8 8 5 2 2 0 0 0 0 2 3 7 7 7 8 29 13 1 2 22 13 5 1 0 0 
#Chair03
0 0 2 4 12 23 4 1 14 34 7 6 6 7 4 3 0 0 0 0 3 2 7 6 7 7 27 13 1 4 19 10 5 1 0 0 
#Chair02
0 0 2 4 12 23 4 1 13 35 6 6 7 7 3 3 0 0 0 0 2 2 7 5 7 7 28 14 1 4 19 10 4 2 0 0 
#Chair014
0 0 2 3 6 5 8 8 28 14 2 3 23 12 7 1 0 0 0 0 1 5 12 21 4 2 12 30 9 5 6 7 3 3 0 0 
#Chair013
0 0 2 3 6 6 8 7 28 14 2 3 23 11 7 0 0 0 0 0 1 5 11 21 3 2 12 30 9 5 6 7 3 3 0 0 
#Chair012
0 0 2 3 6 6 6 8 33 13 1 4 20 11 6 1 0 0 0 0 2 5 11 20 3 2 14 28 8 8 7 5 3 4 0 0 
#Chair011
0 0 2 3 6 6 6 7 32 14 1 4 20 12 7 1 0 0 0 0 2 5 11 21 4 1 14 29 7 8 6 5 3 4 0 0 
#Chair010
0 0 3 3 6 7 7 9 33 14 2 4 21 13 6 1 1 0 0 0 1 4 10 18 2 1 14 27 9 8 6 7 3 2 0 0 
#Chair01
0 0 2 3 6 6 7 7 31 15 2 2 20 11 6 1 0 0 0 0 1 5 11 21 4 2 14 33 9 6 6 6 3 2 0 0 
#Carpet
0 0 0 8 8 9 11 13 12 13 9 11 12 10 6 1 0 0 0 0 1 7 8 10 11 12 11 12 12 10 8 11 6 0 0 0 
