#TV
0 0 0 1 1 3 3 3 4 5 6 7 6 10 10 12 12 13 11 10 8 7 9 9 10 9 11 9 12 9 9 8 5 3 2 1 
#Speaker02
0 0 0 0 0 0 0 0 0 0 0 0 0 1 1 3 6 5 6 7 12 16 17 21 17 16 17 18 19 19 13 11 10 5 2 0 
#Speaker01
0 0 0 0 0 0 0 0 0 0 0 0 1 1 1 2 6 6 7 7 10 13 16 20 16 15 20 18 18 17 17 13 11 6 3 0 
#Desk
1 1 2 6 4 8 8 7 9 9 9 8 8 8 8 6 6 8 8 6 9 10 7 9 13 12 8 6 4 5 5 5 4 4 4 2 
#Chair09
0 0 1 1 2 2 3 4 3 5 6 5 5 5 6 8 7 7 9 8 9 12 12 11 12 13 10 8 8 7 10 7 8 7 8 8 
#Chair08
0 1 1 2 2 3 3 2 4 3 5 6 5 5 7 7 5 8 9 7 11 10 12 11 14 12 10 7 7 8 8 7 10 8 8 8 
#Chair07
0 1 2 2 2 2 4 2 4 4 5 6 5 4 7 7 5 8 9 7 10 10 12 12 14 13 10 6 7 9 9 7 10 8 8 8 
#Chair06
0 1 0 2 3 2 3 3 2 4 7 6 4 6 7 7 7 7 11 11 11 11 8 12 12 14 8 7 7 6 9 7 8 10 9 6 
#Chair05
0 1 1 1 3 2 2 2 4 3 3 6 4 6 7 8 8 8 10 9 10 9 12 13 14 13 8 9 6 7 8 9 9 9 8 6 
#Chair04
0 1 1 1 2 2 2 2 3 3 3 6 4 6 7 8 8 8 9 9 11 9 12 13 15 14 9 9 6 7 8 8 9 9 8 6 
#Chair03
0 0 2 1 2 3 3 3 5 4 3 6 5 6 6 6 5 9 10 8 9 13 11 11 14 12 9 9 7 7 9 8 10 8 8 6 
#Chair02
0 0 2 2 2 3 3 3 5 4 3 6 5 6 7 6 6 9 10 8 9 13 11 11 13 12 9 9 7 7 8 9 10 8 8 5 
#Chair014
0 1 1 1 2 2 3 4 3 4 4 6 8 5 4 8 6 7 9 10 7 10 10 12 13 13 11 8 6 9 10 8 8 10 8 8 
#Chair013
0 1 1 1 2 2 2 4 3 4 4 6 7 5 4 8 6 7 9 10 8 9 10 12 13 13 11 8 6 9 10 8 9 10 8 8 
#Chair012
0 0 1 2 1 3 2 3 3 4 5 6 5 6 7 9 7 8 8 9 9 11 10 12 14 11 10 8 7 8 9 7 10 8 8 7 
#Chair011
0 1 1 2 1 4 2 2 3 4 5 6 5 6 7 8 7 8 8 9 9 11 10 12 14 11 10 8 7 8 9 7 10 8 8 8 
#Chair010
0 0 1 1 2 2 4 3 4 4 5 6 4 5 5 9 7 9 9 8 9 12 10 13 12 14 10 9 7 8 8 7 9 8 9 6 
#Chair01
0 1 1 1 2 3 4 5 5 5 5 7 6 5 6 6 7 9 10 8 8 8 11 12 13 13 9 7 7 8 10 9 8 8 8 6 
#Carpet
0 1 1 2 3 3 4 4 6 6 8 9 9 9 11 12 12 10 9 10 8 8 8 7 8 8 9 9 10 8 9 7 4 3 2 0 
