#Desk
0 0 0 2 6 10 2 6 16 20 14 22 0 0 0 2 8 12 0 0 0 2 5 12 2 8 17 19 18 24 0 0 0 3 7 12 
#Chair05
0 0 0 0 3 4 1 13 31 36 13 4 0 0 0 3 8 15 0 0 0 4 14 6 1 10 31 36 8 4 0 0 0 0 0 1 
#Chair03
0 0 0 0 3 4 2 12 28 35 13 5 0 0 0 3 9 16 0 0 0 6 17 6 1 8 27 34 9 5 0 0 0 0 0 3 
#Chair02
0 0 0 0 5 4 1 12 32 34 13 5 0 0 0 3 10 16 0 0 0 3 11 6 1 9 27 38 8 6 0 0 0 0 0 2 
#Chair01
0 0 0 0 2 3 1 9 32 36 15 5 0 0 0 3 8 15 0 0 0 6 14 7 1 8 27 38 7 6 0 0 0 0 0 1 
