#Desk
7 21 31 36 40 43 40 23 9 1 
#Chair05
11 31 45 52 55 38 14 6 1 0 
#Chair03
10 29 42 51 55 39 16 7 2 0 
#Chair02
10 28 43 51 56 39 16 7 2 0 
#Chair01
11 30 43 51 56 39 15 6 1 0 
