#Desk
0 0 1 1 0 1 0 0 2 2 4 3 3 4 7 6 6 5 7 8 8 8 7 8 8 9 8 10 10 13 14 16 16 15 12 19 
#Chair05
0 0 0 0 1 0 3 3 4 3 4 5 6 6 9 12 10 17 18 14 11 11 11 13 10 10 7 5 6 6 7 6 6 6 7 3 
#Chair03
0 0 0 0 0 1 1 3 3 4 3 4 6 7 9 8 9 13 19 16 12 9 8 12 10 10 7 8 7 8 7 8 7 9 6 3 
#Chair02
0 0 0 0 0 1 2 2 2 4 4 5 4 6 10 9 11 16 18 14 13 10 11 11 9 9 8 4 7 8 9 7 7 8 5 3 
#Chair01
0 0 0 0 0 0 1 2 2 4 3 4 6 8 8 11 11 14 19 15 12 11 12 13 11 10 7 6 7 7 8 7 6 7 4 4 
