#Desk
0 0 1 1 1 2 2 3 3 4 5 4 5 5 6 8 5 5 4 5 6 6 5 5 7 7 9 8 8 7 10 13 19 17 19 25 
#Chair08
0 0 0 1 3 3 3 4 5 5 7 7 7 16 14 15 14 14 12 9 10 9 12 8 6 4 2 2 3 4 5 6 10 6 8 2 
#Chair07
0 0 0 2 3 2 4 5 4 6 6 5 6 12 13 16 15 14 14 9 8 11 11 9 4 4 3 3 3 3 6 8 9 8 8 4 
#Chair06
0 0 0 2 4 3 4 4 4 8 5 6 8 13 16 14 14 12 11 9 11 9 10 8 6 4 4 3 3 3 5 9 9 7 5 3 
#Chair05
0 0 1 2 3 3 4 5 4 8 5 6 8 12 16 14 15 12 11 9 12 9 10 8 6 3 3 4 3 3 6 9 9 7 5 3 
#Chair04
0 0 1 2 4 4 3 4 6 3 6 6 6 12 15 13 15 17 12 11 10 9 8 7 7 5 4 4 4 3 6 8 9 6 8 3 
#Chair03
0 0 1 1 3 4 4 4 4 6 9 6 8 14 14 14 12 13 13 9 9 10 7 10 5 5 3 3 4 4 4 8 11 6 8 3 
#Chair02
0 0 1 1 3 4 4 4 4 6 8 6 8 14 15 15 12 13 13 9 9 10 7 10 5 5 3 3 3 4 5 7 11 6 8 3 
#Chair01
0 0 1 1 3 3 3 3 7 5 7 8 7 14 14 13 15 15 11 8 10 12 8 9 5 4 3 2 3 4 5 9 11 6 6 3 
#CellPhone
0 0 0 1 2 3 3 3 4 7 5 5 5 7 8 9 8 14 12 11 9 8 7 9 8 9 8 7 8 6 7 8 6 14 9 9 
#Book03
0 1 1 1 3 3 3 4 5 4 6 7 8 9 10 8 10 13 13 12 13 11 10 11 8 10 9 7 9 9 7 5 3 3 0 1 
#Book02
0 1 1 2 3 3 3 4 4 4 6 7 8 9 10 9 10 13 13 12 13 11 11 11 8 10 9 7 9 9 7 6 2 3 0 1 
#Book01
0 1 1 2 3 3 3 4 5 4 6 7 8 9 10 8 10 13 13 12 13 11 11 11 8 10 9 7 9 9 7 5 2 3 0 1 
