#Desk
7 19 28 32 35 54 43 23 9 1 
#Chair08
11 33 51 56 52 26 11 7 3 0 
#Chair07
11 33 50 55 51 27 12 8 4 0 
#Chair06
12 34 52 56 51 25 11 7 3 0 
#Chair05
12 34 52 56 51 25 11 7 3 0 
#Chair04
11 33 50 55 52 27 11 8 3 0 
#Chair03
12 34 51 55 51 26 11 8 3 0 
#Chair02
12 34 52 55 51 26 11 7 3 0 
#Chair01
12 34 52 55 51 26 11 8 4 0 
#CellPhone
8 33 44 46 43 31 22 15 9 2 
#Book03
14 36 47 50 45 32 18 9 2 0 
#Book02
14 36 47 50 45 32 18 9 2 0 
#Book01
14 36 47 50 45 32 18 9 2 0 
