#Desk
15 40 53 48 38 29 18 8 3 0 
#Chair06
10 28 47 62 50 30 15 7 3 0 
#Chair05
10 27 46 61 51 30 15 8 3 0 
#Chair04
10 27 46 61 51 30 16 8 3 0 
#Chair03
10 29 49 61 50 28 14 7 2 0 
#Chair02
10 28 46 60 51 29 15 8 3 0 
#Chair01
10 28 46 60 51 30 15 8 4 0 
