#Screen
0 0 0 5 10 12 12 14 14 14 14 14 11 10 5 0 0 0 0 0 0 3 7 10 10 10 13 11 13 13 8 8 4 0 0 0 
#Projector
0 0 0 0 18 9 15 15 8 8 7 8 7 14 16 0 0 0 0 0 0 10 10 7 8 9 9 10 16 15 9 12 5 0 0 0 
#Pencil07
1 1 5 4 8 8 9 10 12 11 11 9 12 6 6 2 1 0 0 0 2 8 10 9 9 7 10 10 11 13 11 9 5 3 2 1 
#Pencil06
1 1 5 4 8 8 8 11 12 11 12 9 12 6 6 2 0 0 0 0 3 7 10 9 10 8 10 10 11 14 11 9 5 3 2 0 
#Pencil05
1 1 5 4 9 8 9 11 12 11 11 9 12 6 6 2 1 0 0 0 2 8 10 9 9 7 10 10 11 14 11 9 4 4 2 0 
#Pencil04
1 1 5 5 9 10 11 10 13 12 10 11 10 8 5 2 0 0 0 0 2 5 7 9 9 12 10 12 10 11 6 9 6 4 1 1 
#Pencil03
1 2 5 6 9 9 10 11 13 12 9 11 10 8 5 2 0 0 0 0 2 5 8 8 9 12 10 13 11 10 6 9 6 4 1 1 
#Pencil02
1 1 5 5 9 10 11 10 13 11 10 11 10 9 5 2 0 0 0 0 2 5 7 9 9 12 10 12 10 11 6 9 6 4 1 1 
#Pencil01
1 2 5 6 9 10 11 10 13 12 10 11 10 8 5 2 0 0 0 0 2 6 7 8 9 12 10 12 11 10 6 9 6 4 1 1 
#Paper07
0 0 0 0 9 12 14 13 15 15 12 13 12 8 0 0 0 0 0 0 0 0 8 13 11 13 14 15 17 14 11 8 0 0 0 0 
#Paper06
0 0 0 0 8 12 14 13 15 15 12 12 12 8 0 0 0 0 0 0 0 0 8 13 11 14 13 15 17 14 11 8 0 0 0 0 
#Paper05
0 0 0 0 9 12 14 13 15 15 12 12 12 8 0 0 0 0 0 0 0 0 8 13 11 13 14 14 17 14 11 8 0 0 0 0 
#Paper04
0 0 0 0 8 12 14 13 16 15 12 12 12 8 0 0 0 0 0 0 0 0 8 13 11 14 14 14 17 14 11 9 0 0 0 0 
#Paper03
0 0 0 0 9 11 13 15 13 14 15 13 11 8 0 0 0 0 0 0 0 0 8 13 11 14 16 14 15 14 11 8 0 0 0 0 
#Paper02
0 0 0 0 8 11 14 15 13 14 15 13 11 9 0 0 0 0 0 0 0 0 8 13 11 14 15 14 15 13 12 8 0 0 0 0 
#Paper01
0 0 0 0 8 11 14 15 13 14 16 13 11 8 0 0 0 0 0 0 0 0 8 13 12 13 16 14 15 14 12 7 0 0 0 0 
#Desk
0 0 1 7 6 9 11 14 12 12 11 12 8 7 7 0 0 0 0 0 2 7 7 8 12 11 10 12 13 12 13 8 8 2 0 0 
#Chair07
0 0 4 10 11 12 14 24 13 0 0 0 0 5 10 1 0 0 0 0 6 3 5 10 13 15 19 19 0 0 18 19 14 1 0 0 
#Chair06
0 0 4 10 11 12 13 24 13 0 0 0 0 5 10 1 0 0 0 0 7 3 5 10 13 15 18 19 0 0 19 19 14 1 0 0 
#Chair05
0 0 4 10 11 13 14 24 12 0 0 0 0 5 10 1 0 0 0 0 7 3 5 10 13 15 18 19 0 0 19 18 14 1 0 0 
#Chair04
0 0 6 11 8 12 11 24 13 0 0 0 1 5 9 1 0 0 0 0 5 3 4 8 14 13 19 20 0 0 20 21 13 0 0 0 
#Chair03
0 0 6 10 9 13 12 23 13 0 0 0 2 5 9 1 0 0 0 0 5 4 4 8 14 14 19 19 0 0 22 21 13 0 0 0 
#Chair02
0 0 6 10 8 13 12 24 13 0 0 0 2 6 9 1 0 0 0 0 5 3 4 8 14 14 19 19 0 0 22 21 12 0 0 0 
#Chair01
0 0 6 10 8 12 12 24 13 0 0 0 1 5 9 1 0 0 0 0 5 3 4 8 14 14 19 19 0 0 21 21 13 0 0 0 
#Board
0 0 5 8 10 9 15 22 27 12 0 1 1 1 0 0 0 0 0 0 0 1 1 1 2 1 7 29 27 26 15 11 7 2 1 0 
#AirVent02
0 0 0 5 17 8 10 10 9 12 12 10 10 13 5 0 0 0 0 0 0 5 16 9 9 12 10 10 12 11 11 12 5 0 0 0 
#AirVent01
0 0 0 5 12 11 11 12 10 10 12 10 10 16 5 0 0 0 0 0 0 5 13 10 11 11 12 9 9 10 8 17 5 0 0 0 
