#Screen
0 0 0 6 15 6 5 16 26 32 4 0 0 0 0 6 14 5 0 0 0 7 9 3 4 13 26 24 2 0 0 0 0 6 11 4 
#Projector
0 0 0 1 10 16 0 4 12 14 26 4 0 0 0 1 20 16 0 0 0 1 14 12 0 5 12 19 30 1 0 0 0 2 9 16 
#Pencil07
0 0 0 10 10 10 22 23 19 0 0 0 0 0 0 14 9 5 0 0 0 11 15 5 20 19 25 0 0 0 0 0 0 12 12 8 
#Pencil06
0 0 0 10 10 11 21 24 18 0 0 0 0 0 0 13 9 5 0 0 0 11 14 5 20 19 25 0 0 0 0 0 0 12 12 8 
#Pencil05
0 0 0 10 10 10 22 23 19 0 0 0 0 0 0 14 9 5 0 0 0 11 14 5 20 19 25 0 0 0 0 0 0 12 11 8 
#Pencil04
0 0 0 11 11 11 25 20 23 0 0 0 0 0 0 11 12 3 0 0 0 10 11 4 21 23 21 0 0 0 0 0 0 8 12 9 
#Pencil03
0 0 0 11 11 11 25 20 23 0 0 0 0 0 0 11 12 3 0 0 0 9 11 4 22 23 21 0 0 0 0 0 0 8 13 9 
#Pencil02
0 0 0 11 11 11 24 20 23 0 0 0 0 0 0 11 12 3 0 0 0 10 11 4 21 23 22 0 0 0 0 0 0 8 12 9 
#Pencil01
0 0 0 11 11 11 24 20 23 0 0 0 0 0 0 11 12 4 0 0 0 9 11 4 22 23 21 0 0 0 0 0 0 8 13 9 
#Paper07
0 0 0 7 11 3 7 17 28 23 8 0 0 0 0 6 10 4 0 0 0 6 11 3 5 18 27 26 8 0 0 0 0 5 10 4 
#Paper06
0 0 0 7 11 3 7 17 28 24 8 0 0 0 0 5 10 4 0 0 0 6 10 3 5 18 28 25 9 0 0 0 0 4 10 4 
#Paper05
0 0 0 7 11 3 7 17 28 23 8 0 0 0 0 5 10 4 0 0 0 6 11 4 5 18 28 25 8 0 0 0 0 5 10 4 
#Paper04
0 0 0 6 11 3 7 17 28 24 8 0 0 0 0 5 10 4 0 0 0 6 10 4 5 18 29 25 8 0 0 0 0 4 11 3 
#Paper03
0 0 0 4 11 3 4 16 29 27 8 0 0 0 0 6 11 2 0 0 0 7 11 3 5 18 28 27 6 0 0 0 0 5 10 3 
#Paper02
0 0 0 4 11 3 4 16 30 27 8 0 0 0 0 6 12 2 0 0 0 6 11 4 5 18 28 26 7 0 0 0 0 5 10 3 
#Paper01
0 0 0 4 11 3 4 16 30 27 8 0 0 0 0 6 11 2 0 0 0 7 11 3 5 18 28 27 7 0 0 0 0 6 10 3 
#Desk
0 0 0 6 10 8 6 16 33 17 0 0 0 0 0 5 11 7 0 0 0 4 11 9 4 17 33 15 0 0 0 0 0 8 14 10 
#Chair07
0 0 0 7 17 13 1 9 19 21 0 0 0 0 0 0 7 9 0 0 0 8 8 9 2 16 34 14 0 0 0 0 0 0 26 26 
#Chair06
0 0 0 7 17 13 1 8 20 21 0 0 0 0 0 0 7 9 0 0 0 8 8 9 3 16 33 14 0 0 0 0 0 0 26 27 
#Chair05
0 0 0 7 17 13 1 7 20 21 0 0 0 0 0 0 7 9 0 0 0 8 8 9 2 16 33 13 0 0 0 0 0 0 26 27 
#Chair04
0 0 0 7 16 16 1 11 17 18 0 0 0 0 0 1 7 9 0 0 0 6 8 7 3 14 35 14 0 0 0 0 0 0 28 27 
#Chair03
0 0 0 7 15 16 1 11 18 18 0 0 0 0 0 1 7 9 0 0 0 6 8 7 3 14 35 14 0 0 0 0 0 0 29 27 
#Chair02
0 0 0 7 15 16 1 11 18 18 0 0 0 0 0 1 8 9 0 0 0 6 8 7 3 14 35 14 0 0 0 0 0 0 29 27 
#Chair01
0 0 0 7 16 16 1 11 18 18 0 0 0 0 0 1 7 9 0 0 0 6 8 7 3 14 35 14 0 0 0 0 0 0 28 27 
#Board
0 0 0 8 15 9 13 35 25 5 0 0 0 0 0 0 1 0 0 0 0 0 2 2 11 34 39 8 0 0 0 0 0 15 16 8 
#AirVent02
0 0 0 3 19 7 2 8 22 27 3 0 0 0 0 5 17 6 0 0 0 3 20 7 3 8 22 28 3 0 0 0 0 4 19 5 
#AirVent01
0 0 0 4 19 5 3 9 22 28 3 0 0 0 0 3 21 6 0 0 0 5 18 6 2 8 22 26 3 0 0 0 0 4 19 7 
