#Screen
14 34 45 48 45 35 19 9 2 0 
#Projector
6 16 29 37 41 43 42 28 9 0 
#Pencil07
49 45 39 33 28 23 17 12 5 1 
#Pencil06
49 45 39 33 28 23 17 11 5 1 
#Pencil05
49 45 39 33 28 23 17 11 5 1 
#Pencil04
49 46 40 34 28 22 16 11 5 0 
#Pencil03
49 46 40 34 28 22 16 11 5 0 
#Pencil02
49 46 40 34 28 22 17 11 5 0 
#Pencil01
49 46 40 34 28 22 16 11 5 0 
#Paper07
14 35 47 50 45 34 19 6 1 0 
#Paper06
14 36 47 50 45 34 19 6 1 0 
#Paper05
14 35 47 50 45 34 19 6 1 0 
#Paper04
14 36 47 50 45 34 19 6 1 0 
#Paper03
14 36 47 50 46 34 18 6 1 0 
#Paper02
14 36 47 50 46 34 19 6 1 0 
#Paper01
14 36 47 50 46 34 18 6 1 0 
#Desk
11 37 49 53 39 27 19 11 4 0 
#Chair07
9 27 38 54 51 30 18 15 9 0 
#Chair06
9 27 38 54 51 30 18 15 9 0 
#Chair05
9 27 37 54 51 30 18 15 9 0 
#Chair04
9 26 37 56 52 29 17 15 9 0 
#Chair03
9 26 37 56 52 29 17 15 9 0 
#Chair02
9 26 37 56 52 29 17 15 8 0 
#Chair01
9 26 37 56 52 30 17 15 9 0 
#Board
35 75 69 42 19 7 3 2 0 0 
#AirVent02
14 30 39 42 44 38 25 16 3 0 
#AirVent01
14 30 39 42 44 38 25 17 3 0 
