#Desk
12 34 45 45 42 31 25 12 4 0 
#Chair09
11 37 58 61 43 24 11 5 2 0 
#Chair08
11 37 58 61 42 25 11 5 2 0 
#Chair07
11 38 58 59 42 25 11 5 2 0 
#Chair06
11 36 58 61 43 25 11 5 2 0 
#Chair05
11 37 58 61 43 24 11 4 1 0 
#Chair04
11 35 56 60 44 26 12 5 2 0 
#Chair03
11 34 56 61 44 25 12 5 2 0 
#Chair02
11 36 58 61 43 25 11 5 2 0 
#Chair010
11 35 56 61 44 25 12 5 2 0 
#Chair01
11 36 57 61 42 25 12 5 2 0 
