#Desk
0 0 0 3 10 9 0 9 32 32 4 0 0 0 0 6 11 8 0 0 0 5 10 8 0 11 31 27 4 0 0 0 0 4 10 10 
#Chair09
0 0 0 4 2 7 1 22 56 10 0 0 0 0 0 4 8 8 0 0 0 4 9 8 1 19 54 11 1 0 0 0 0 5 4 7 
#Chair08
0 0 0 4 3 6 1 20 56 12 0 0 0 0 0 4 7 9 0 0 0 5 9 9 1 22 53 11 1 0 0 0 0 4 4 6 
#Chair07
0 0 0 5 3 8 3 23 53 12 0 0 0 0 0 6 8 8 0 0 0 3 7 9 1 22 47 11 1 0 0 0 0 4 4 6 
#Chair06
0 0 0 5 2 7 1 20 57 9 0 0 0 0 0 5 8 8 0 0 0 4 7 9 1 18 55 11 0 0 0 0 0 4 3 8 
#Chair05
0 0 0 4 3 5 1 21 51 12 0 0 0 0 0 6 8 9 0 0 0 3 8 9 1 22 54 14 0 0 0 0 0 5 2 6 
#Chair04
0 0 0 5 3 6 0 17 51 13 0 0 0 0 0 5 6 11 0 0 0 4 7 11 1 22 57 12 0 0 0 0 0 3 2 6 
#Chair03
0 0 0 5 4 6 1 20 54 14 1 0 0 0 0 5 7 9 0 0 0 4 7 10 0 17 55 10 0 0 0 0 0 3 4 6 
#Chair02
0 0 0 4 4 7 1 20 55 11 0 0 0 0 0 4 8 8 0 0 0 5 9 8 1 22 55 11 0 0 0 0 0 4 4 6 
#Chair010
0 0 0 4 3 7 1 19 55 11 0 0 0 0 0 6 7 9 0 0 0 3 9 9 1 20 53 14 0 0 0 0 0 5 2 7 
#Chair01
0 0 0 5 4 7 0 20 56 11 0 0 0 0 0 5 7 8 0 0 0 6 8 8 1 21 51 11 0 0 0 0 0 4 3 8 
