#Desk
0 0 0 0 0 0 0 1 2 5 4 5 6 7 7 9 17 16 12 9 11 11 12 23 14 6 8 6 9 7 8 7 5 3 7 6 
#Chair09
0 0 0 0 1 1 1 3 3 6 14 12 16 22 24 15 16 14 9 5 6 7 6 6 5 4 4 4 3 3 2 4 6 7 8 2 
#Chair08
0 0 0 0 0 1 1 2 3 6 13 15 16 22 22 19 15 14 11 9 6 7 4 3 4 4 4 3 4 5 4 3 6 10 4 2 
#Chair07
0 0 0 0 2 1 1 3 3 7 12 17 16 21 21 14 14 12 9 9 7 7 5 5 4 4 4 4 4 3 4 5 6 9 6 2 
#Chair06
0 0 0 0 0 2 1 2 3 6 10 14 16 23 23 18 15 16 9 7 9 6 4 4 3 4 4 4 3 3 2 4 9 8 6 2 
#Chair05
0 0 0 0 1 1 2 2 3 7 12 14 18 20 22 18 12 14 9 10 8 8 4 5 4 5 4 4 3 2 5 4 5 8 6 2 
#Chair04
0 0 0 0 0 1 1 2 4 6 11 13 15 21 22 17 17 15 8 8 8 9 6 3 3 4 3 3 3 4 3 6 7 8 8 3 
#Chair03
0 0 0 0 0 1 1 1 3 7 12 12 18 20 22 17 16 13 9 9 8 6 6 4 4 3 4 5 4 3 4 5 6 9 7 2 
#Chair02
0 0 0 0 0 1 1 2 4 7 11 15 18 19 24 15 17 14 8 8 5 8 4 5 4 5 5 3 4 3 2 3 7 8 6 3 
#Chair010
0 0 0 0 0 1 1 1 2 7 12 13 18 18 21 16 17 16 10 8 8 6 5 5 4 4 4 4 2 3 3 4 5 11 6 2 
#Chair01
0 0 0 0 0 1 2 2 4 5 12 14 20 20 22 15 15 14 8 8 7 9 4 6 3 3 5 4 3 4 3 5 6 7 7 2 
