#Picture04
0 0 0 4 12 11 10 11 10 12 10 9 12 12 4 0 0 0 0 0 0 5 11 11 11 11 12 14 12 11 11 14 4 0 0 0 
#Picture03
0 0 3 8 9 9 10 11 11 12 10 10 10 8 7 3 0 0 0 0 3 7 9 9 10 12 11 11 11 11 12 7 6 2 0 0 
#Picture02
0 0 0 3 9 13 14 15 14 11 14 14 14 8 3 0 0 0 0 0 0 0 7 11 11 13 13 13 14 13 11 7 0 0 0 0 
#Picture01
0 0 0 7 9 9 13 12 12 13 12 14 9 9 7 0 0 0 0 0 0 8 7 9 10 10 12 9 13 11 10 10 9 0 0 0 
#Desk
0 1 1 4 11 13 11 9 14 15 10 9 10 8 4 2 1 0 0 2 3 3 10 13 10 9 12 13 8 8 12 8 4 3 1 0 
#Chair09
0 0 3 3 6 8 7 7 31 17 2 2 18 10 7 1 0 0 0 0 1 5 11 21 3 1 9 29 11 7 7 5 3 2 0 0 
#Chair08
0 0 2 4 6 8 7 9 31 11 2 2 19 13 6 1 1 0 0 0 1 7 11 20 5 1 16 32 6 6 5 6 3 2 0 0 
#Chair07
0 0 2 4 7 6 8 7 30 15 2 2 20 12 5 2 0 0 0 0 1 7 11 23 4 1 14 29 8 7 7 5 4 2 0 0 
#Chair06
0 0 3 3 5 7 6 8 25 15 3 4 21 11 6 2 1 0 0 0 1 6 10 22 3 2 13 30 9 6 7 6 3 3 0 0 
#Chair05
0 0 3 5 7 6 7 8 28 15 3 3 23 10 7 2 0 0 0 0 2 6 11 21 2 1 11 29 8 7 6 7 3 3 0 0 
#Chair04
0 0 4 5 7 6 7 8 27 15 2 3 22 10 7 2 0 0 0 0 2 6 10 21 3 2 11 29 7 6 6 7 3 3 0 0 
#Chair03
0 0 2 4 6 6 9 8 30 13 2 2 19 11 7 1 0 0 0 0 2 6 9 20 5 1 13 33 7 6 7 5 2 3 0 0 
#Chair02
0 0 3 3 7 7 7 8 31 15 2 3 19 11 4 1 0 0 0 0 2 6 12 19 3 2 16 32 8 6 6 5 3 2 0 0 
#Chair014
0 0 1 3 4 8 8 9 33 16 2 3 21 10 5 1 0 0 0 0 1 6 10 23 3 2 14 28 7 6 6 7 3 2 0 0 
#Chair013
0 0 3 2 6 6 6 9 31 15 3 3 21 9 7 2 0 0 0 0 2 5 11 22 3 2 13 27 8 8 5 6 3 3 0 0 
#Chair012
0 0 3 3 6 7 7 8 27 15 2 3 22 11 4 2 0 0 0 0 1 7 10 23 3 3 13 30 9 8 6 7 3 2 0 0 
#Chair011
0 0 3 3 6 7 6 7 27 15 2 2 22 11 5 2 0 0 0 0 1 6 10 22 3 3 13 30 9 8 6 7 3 2 0 0 
#Chair010
0 0 2 4 7 7 8 8 25 17 2 3 19 10 5 1 1 0 0 0 1 5 11 21 3 2 15 31 8 7 6 6 3 3 0 0 
#Chair01
0 0 3 3 6 8 8 8 29 14 3 3 20 13 6 1 0 0 0 1 2 5 9 18 3 2 12 29 9 8 7 6 4 1 0 0 
#CellingLight04
0 1 3 4 6 8 10 13 16 14 13 11 9 6 4 3 2 0 1 2 2 4 7 10 9 12 11 12 13 10 7 6 4 4 2 0 
#CellingLight03
1 1 2 4 8 9 12 13 13 13 12 10 9 6 3 2 2 1 0 2 2 4 6 9 11 12 11 13 13 9 10 7 3 2 1 1 
#CellingLight02
1 1 3 4 8 9 13 13 13 12 13 11 9 6 4 2 2 1 0 2 3 5 6 9 10 12 11 12 13 9 10 7 3 2 1 1 
#CellingLight01
0 1 2 4 7 9 10 13 13 12 13 10 9 6 4 4 1 1 1 1 2 5 7 11 9 11 12 12 14 8 8 7 6 3 2 0 
#Bonsai03
0 0 2 0 2 7 4 6 27 5 0 0 18 18 12 7 2 0 0 2 7 16 28 21 1 1 6 27 3 6 7 2 2 1 0 0 
#Bonsai02
0 0 2 0 2 6 6 4 30 6 0 0 17 18 10 7 1 0 0 3 9 14 30 22 1 1 6 25 2 8 7 2 2 1 0 0 
#Bonsai01
0 0 3 1 1 6 6 4 29 6 0 0 16 17 10 7 2 0 0 4 9 14 31 21 1 1 6 25 2 8 7 2 2 1 0 0 
