#Picture04
0 0 0 1 2 1 2 4 2 4 5 5 5 4 7 5 7 8 5 8 7 11 17 14 12 12 12 15 15 11 11 9 6 6 4 2 
#Picture03
0 0 1 2 3 2 3 6 7 5 8 8 8 8 8 14 12 9 10 7 8 8 8 8 10 9 9 7 9 7 8 10 8 5 3 0 
#Picture02
0 0 1 1 2 2 3 3 3 4 6 5 7 7 7 8 7 9 12 13 13 15 15 16 13 11 11 9 9 5 5 4 3 3 5 2 
#Picture01
0 1 1 1 2 2 2 3 4 4 5 5 5 6 8 8 8 8 9 9 11 14 14 11 10 12 10 9 16 11 9 5 4 5 3 3 
#Desk
0 1 3 6 6 6 6 8 9 10 10 8 8 7 6 6 7 8 8 7 10 9 12 10 9 10 10 6 4 6 3 4 2 5 4 2 
#Chair09
0 1 1 2 1 1 3 4 3 6 3 4 6 5 8 8 6 9 10 7 11 11 14 11 14 9 11 9 7 8 9 8 7 9 8 7 
#Chair08
0 1 1 2 1 3 2 4 5 3 4 5 6 5 7 8 6 7 9 8 7 12 10 12 14 13 9 9 6 9 9 10 6 8 8 6 
#Chair07
0 0 1 2 2 3 2 3 4 4 4 7 6 5 6 8 6 7 9 9 10 9 11 10 14 12 9 8 8 10 9 7 9 9 9 6 
#Chair06
0 1 1 1 2 2 2 3 3 4 6 6 4 5 5 8 8 7 8 8 8 13 12 13 13 14 11 7 6 6 8 8 8 10 12 6 
#Chair05
0 1 1 1 3 2 3 3 3 3 4 6 3 6 5 7 6 10 9 8 8 12 10 12 15 11 10 8 7 7 8 8 10 9 10 8 
#Chair04
0 1 1 1 3 2 3 3 2 3 4 6 4 6 5 8 7 10 9 7 8 12 10 13 15 11 10 8 7 6 8 8 10 9 10 7 
#Chair03
0 0 1 2 1 3 3 5 4 4 3 6 6 6 7 6 9 7 9 9 12 10 9 11 11 12 11 9 6 9 9 7 7 10 8 7 
#Chair02
0 1 1 1 2 3 4 4 4 4 5 6 5 7 6 7 7 9 11 8 11 11 8 13 13 13 10 8 6 8 7 7 7 8 9 6 
#Chair014
0 0 1 2 1 3 3 3 4 4 5 6 5 6 6 8 9 9 9 8 11 11 10 11 14 11 8 6 8 7 11 8 6 10 6 5 
#Chair013
0 1 0 1 4 2 4 3 4 5 4 5 4 5 7 6 8 8 10 7 9 10 11 12 12 13 10 8 6 8 7 8 9 10 11 7 
#Chair012
0 0 1 1 2 2 1 3 3 3 4 8 4 7 5 6 6 7 9 8 12 11 13 11 13 14 9 9 7 8 8 8 7 9 10 7 
#Chair011
0 1 1 1 2 2 1 3 3 3 4 8 5 7 5 6 6 7 9 8 13 11 12 11 13 14 9 9 7 9 8 8 7 8 10 7 
#Chair010
0 1 1 0 2 2 4 4 3 5 3 6 5 6 7 8 7 7 9 9 13 10 12 12 14 12 12 8 8 7 7 7 9 8 9 7 
#Chair01
0 0 1 2 3 3 4 3 4 4 4 6 5 6 6 7 7 7 10 6 9 9 12 12 14 13 8 8 8 7 10 7 8 7 10 7 
#CellingLight04
0 0 0 1 1 1 2 3 3 3 3 4 4 7 5 4 6 5 7 6 8 8 7 8 8 8 8 9 8 8 9 11 11 11 9 42 
#CellingLight03
0 0 0 1 1 2 2 2 2 2 4 3 4 5 4 5 6 6 6 5 5 7 9 8 8 9 11 9 9 9 8 11 10 9 12 42 
#CellingLight02
0 0 0 0 1 2 1 1 2 2 4 3 4 5 4 5 5 6 6 6 5 7 9 8 8 10 11 9 10 9 8 11 10 9 12 42 
#CellingLight01
0 0 1 0 2 1 1 2 2 2 5 4 5 6 4 4 5 6 6 6 7 7 7 8 6 10 8 8 9 11 10 11 9 11 11 44 
#Bonsai03
0 0 0 1 1 0 0 1 3 3 4 5 3 3 5 4 4 5 6 3 7 6 11 19 22 19 11 17 17 13 11 9 9 6 6 3 
#Bonsai02
0 0 0 1 1 1 1 2 3 4 3 4 4 6 4 4 5 6 5 5 6 6 12 19 22 17 12 14 17 12 10 9 7 9 8 3 
#Bonsai01
0 0 0 1 1 1 0 2 3 4 3 5 4 6 3 4 5 6 5 5 6 5 12 19 22 17 12 14 17 12 10 8 7 9 8 3 
