#Desk
0 0 0 9 9 6 22 10 6 9 10 20 9 8 8 0 0 0 0 0 0 8 7 8 17 8 7 10 11 17 8 6 11 0 0 0 
#Chair09
0 0 0 1 3 8 7 16 25 19 14 9 6 6 4 3 1 0 0 1 5 3 6 6 7 14 19 23 17 6 10 3 2 0 0 0 
#Chair08
0 0 1 1 4 7 6 21 24 17 13 7 4 5 4 5 0 0 0 0 4 4 6 7 9 12 16 23 19 8 9 3 1 0 0 0 
#Chair07
0 0 0 1 4 10 6 20 25 17 13 9 8 4 5 4 0 0 0 1 4 5 5 4 6 11 16 25 18 5 9 3 1 1 0 0 
#Chair06
0 0 0 2 4 8 6 20 26 17 11 8 6 6 5 3 0 0 0 0 4 5 5 6 10 13 20 22 16 5 10 2 1 1 0 0 
#Chair05
0 0 0 1 3 7 5 19 24 17 14 7 7 6 4 5 0 0 0 1 3 4 6 5 7 17 18 22 19 6 9 3 1 0 0 0 
#Chair04
0 0 0 2 4 8 7 18 21 16 13 7 6 4 5 6 1 0 0 1 5 6 4 5 9 13 20 25 19 6 8 2 1 0 0 0 
#Chair03
0 0 1 1 3 10 6 20 22 18 14 8 6 4 5 4 1 0 0 0 4 6 5 5 7 12 19 21 18 6 8 4 2 0 0 0 
#Chair02
0 0 0 3 2 8 7 17 26 17 12 8 5 6 3 4 0 0 0 0 4 5 5 6 6 15 17 24 21 6 8 3 2 0 0 0 
#Chair010
0 0 0 2 3 9 6 17 22 20 10 10 7 5 5 4 0 0 0 0 4 5 6 4 8 14 19 22 17 8 9 3 1 0 0 0 
#Chair01
0 0 0 2 4 9 7 21 22 18 12 7 6 4 5 4 0 0 0 0 4 4 7 7 9 12 16 23 17 7 9 3 2 1 0 0 
