#TV02
0 0 0 10 6 9 11 12 12 11 12 11 12 8 8 0 0 0 0 0 0 9 8 10 11 11 14 11 12 12 9 8 10 0 0 0 
#TV01
0 0 0 11 7 11 11 10 13 11 10 9 8 9 12 0 0 0 0 0 0 11 6 11 11 12 13 11 10 11 11 7 9 0 0 0 
#Desk
0 1 9 6 7 8 9 11 8 11 9 9 8 6 5 8 2 0 0 2 10 5 7 8 8 9 10 10 12 11 11 9 5 8 2 0 
#Chair09
0 0 0 0 0 1 1 9 22 17 23 13 12 9 7 4 0 0 0 0 3 5 11 13 9 24 24 19 11 2 1 0 1 0 0 0 
#Chair08
0 0 0 0 1 1 2 10 18 18 20 11 16 11 7 5 0 0 0 1 5 8 11 10 12 24 18 18 13 3 1 1 0 0 0 0 
#Chair07
0 0 0 0 0 1 1 13 21 18 20 9 12 10 6 4 0 0 0 0 5 7 11 13 13 22 19 19 11 2 1 1 1 0 0 0 
#Chair06
0 0 0 1 1 1 1 12 20 19 23 12 14 10 7 5 0 0 0 0 3 7 9 11 12 22 17 20 11 2 1 0 1 0 0 0 
#Chair05
0 0 0 1 1 1 3 13 19 20 21 11 12 11 5 6 0 0 0 1 5 6 10 12 11 23 18 18 10 2 1 1 1 0 0 0 
#Chair04
0 0 0 1 0 1 2 11 18 19 24 11 12 9 7 4 0 0 0 1 4 7 10 13 10 24 19 20 12 2 1 0 0 0 0 0 
#Chair03
0 0 0 1 1 1 3 10 22 16 20 11 13 10 6 3 1 0 0 1 3 6 10 14 11 22 20 21 13 2 1 0 1 0 0 0 
#Chair02
0 0 0 1 0 1 2 13 17 20 20 12 12 12 6 4 0 0 0 0 5 7 11 12 11 21 18 19 13 1 1 0 0 0 0 0 
#Chair010
0 0 0 0 0 1 3 11 18 19 22 10 11 9 8 6 0 0 0 0 6 7 9 11 11 22 21 20 11 2 1 0 1 0 0 0 
#Chair01
0 0 0 2 1 1 2 11 20 19 21 13 12 9 4 5 0 0 0 0 4 6 11 13 11 24 19 19 12 2 0 1 1 0 0 0 
