#TV02
13 35 46 48 44 30 20 12 4 0 
#TV01
13 34 45 47 44 30 20 13 5 0 
#Desk
19 44 49 38 30 24 19 14 9 4 
#Chair09
11 33 52 61 53 31 8 3 0 0 
#Chair08
11 31 50 58 53 34 10 3 1 0 
#Chair07
11 32 51 61 53 32 9 3 1 0 
#Chair06
11 31 51 60 53 32 9 3 1 0 
#Chair05
11 31 50 60 53 33 10 3 1 0 
#Chair04
11 32 50 60 53 33 9 3 1 0 
#Chair03
11 30 49 59 53 34 10 3 1 0 
#Chair02
11 31 51 60 53 33 8 3 0 0 
#Chair010
11 31 50 60 53 33 9 3 1 0 
#Chair01
11 32 52 60 53 32 8 3 1 0 
