#TV02
0 0 0 4 13 8 3 16 28 21 1 0 0 0 0 7 13 7 0 0 0 5 13 8 4 13 29 23 0 0 0 0 0 4 15 8 
#TV01
0 0 0 7 14 8 4 15 27 18 0 0 0 0 0 4 14 10 0 0 0 6 13 10 4 14 30 18 1 0 0 0 0 6 13 9 
#Desk
0 0 0 7 11 15 1 24 26 6 0 0 0 0 0 6 10 15 0 0 0 7 9 16 1 25 27 7 0 0 0 0 0 9 12 14 
#Chair09
0 0 0 0 0 1 3 13 30 30 8 1 0 0 0 5 17 10 0 0 0 6 19 8 2 21 30 29 7 1 0 0 0 1 0 1 
#Chair08
0 0 0 0 0 1 3 11 27 28 9 1 0 0 0 9 18 12 0 0 0 5 17 13 3 16 25 32 9 2 0 0 0 0 1 1 
#Chair07
0 0 0 0 1 0 4 16 28 28 6 1 0 0 0 4 19 10 0 0 0 7 18 12 3 15 31 30 8 0 0 0 0 0 1 2 
#Chair06
0 0 0 1 0 2 2 17 29 29 8 1 0 0 0 7 19 11 0 0 0 6 16 9 3 15 29 27 9 1 0 0 0 1 0 1 
#Chair05
0 0 0 0 1 1 2 16 30 31 7 1 0 0 0 6 18 11 0 0 0 7 16 12 2 16 28 28 8 0 0 0 0 0 1 1 
#Chair04
0 0 0 0 0 1 3 15 31 27 7 1 0 0 0 6 16 12 0 0 0 5 19 11 3 15 31 30 6 2 0 0 0 1 0 1 
#Chair03
0 0 0 0 1 2 2 15 29 29 8 1 0 0 0 5 18 10 0 0 0 7 18 10 3 15 30 30 7 2 0 0 0 1 1 1 
#Chair02
0 0 0 1 0 1 4 19 24 29 8 1 0 0 0 6 20 10 0 0 0 5 19 11 2 15 26 32 8 1 0 0 0 0 1 1 
#Chair010
0 0 0 0 1 1 3 15 28 29 7 1 0 0 0 5 18 13 0 0 0 6 15 13 3 17 28 30 8 1 0 0 0 0 0 1 
#Chair01
0 0 0 0 1 3 3 14 28 31 8 1 0 0 0 5 16 10 0 0 0 8 16 10 4 16 30 29 7 1 0 0 0 0 0 1 
