#TV02
0 0 0 1 3 3 4 4 6 5 4 5 7 7 7 9 14 11 11 14 12 9 10 9 9 8 7 8 11 11 12 8 6 3 2 0 
#TV01
0 0 0 1 2 3 2 4 5 5 5 6 6 7 7 8 13 13 12 10 10 9 8 9 9 8 9 8 11 12 13 9 7 4 2 0 
#Desk
0 0 0 0 0 3 5 6 10 8 9 10 10 8 9 8 8 7 7 6 8 7 6 7 8 7 5 8 7 4 7 6 7 14 12 12 
#Chair09
0 0 0 1 1 3 2 3 5 7 6 9 9 9 9 12 9 9 10 10 11 14 13 13 10 7 10 7 10 7 4 3 4 6 4 1 
#Chair08
0 0 0 0 2 3 2 2 5 5 6 6 8 8 7 10 9 8 12 10 11 13 14 14 11 8 8 10 11 7 6 6 6 5 6 1 
#Chair07
0 0 0 1 1 3 2 3 5 5 6 8 11 9 10 11 9 8 10 9 13 10 15 13 10 7 8 9 10 8 4 5 6 5 4 1 
#Chair06
0 0 0 0 3 1 2 3 4 7 7 8 8 10 9 11 8 10 10 9 12 11 14 14 9 8 9 12 8 7 5 4 4 6 5 1 
#Chair05
0 0 0 1 1 2 2 3 6 7 6 6 10 8 8 11 8 10 8 12 11 14 14 13 11 7 7 9 10 7 4 5 5 5 5 3 
#Chair04
0 0 0 0 2 2 2 3 4 6 6 7 9 10 9 10 10 11 7 11 11 10 17 13 8 7 9 8 11 6 5 6 5 6 4 1 
#Chair03
0 0 0 0 1 3 2 3 6 6 6 6 9 8 9 11 10 10 9 12 11 13 15 13 10 7 9 9 10 8 5 4 4 5 4 2 
#Chair02
0 0 0 1 2 3 2 4 6 7 7 8 9 7 8 8 8 8 9 12 11 11 16 13 11 9 10 9 10 8 5 4 6 4 4 1 
#Chair010
0 0 1 1 1 2 4 2 5 5 7 8 10 8 10 9 9 8 9 11 9 10 13 17 8 7 8 8 10 7 6 5 7 6 6 1 
#Chair01
0 0 1 0 2 3 2 3 4 6 7 7 11 10 8 10 9 9 11 11 11 13 15 14 10 7 7 8 11 6 6 4 4 5 4 2 
