#Desk
0 0 1 6 10 10 9 15 9 12 13 11 8 10 7 2 0 0 0 0 1 4 13 8 8 14 11 10 15 8 10 9 6 1 0 0 
#Chair09
0 0 0 1 3 8 7 19 24 17 13 11 7 4 3 7 0 0 0 0 4 3 5 7 8 12 17 22 19 6 9 3 1 1 0 0 
#Chair08
0 0 1 2 3 8 7 19 22 19 16 9 7 5 4 4 0 0 0 0 4 4 5 7 9 12 16 23 16 6 10 3 2 1 0 0 
#Chair07
0 0 1 1 3 9 7 18 23 17 13 9 6 5 4 5 0 0 0 0 4 5 6 5 8 15 18 24 16 7 7 3 2 0 0 0 
#Chair06
0 0 0 2 2 11 6 18 22 18 13 6 5 5 7 4 0 0 0 0 4 4 5 7 8 13 18 23 18 6 10 3 3 0 0 0 
#Chair05
0 0 0 3 4 8 7 21 23 19 11 8 7 7 5 4 0 0 0 0 4 4 5 6 8 13 18 22 18 7 8 1 2 0 0 0 
#Chair04
0 0 1 2 3 9 7 18 20 18 16 8 5 5 4 5 0 0 0 0 5 4 5 6 9 17 16 22 17 5 6 3 3 1 0 0 
#Chair03
0 0 0 1 6 8 6 19 20 17 13 8 6 5 5 4 0 0 0 0 5 4 5 6 7 13 19 23 19 8 11 2 2 1 0 0 
#Chair02
0 0 1 1 2 8 6 17 24 18 12 8 5 5 5 4 0 0 0 0 5 5 6 8 10 11 18 25 20 6 8 4 1 0 0 0 
#Chair010
0 0 1 1 4 9 7 20 23 17 12 7 4 5 3 4 0 0 0 0 4 6 6 8 9 11 20 23 17 6 8 3 2 1 0 0 
#Chair01
0 0 1 1 2 10 6 19 22 19 12 8 5 6 5 3 0 0 0 0 4 3 5 7 8 14 18 24 20 6 9 5 2 1 0 0 
