#Desk
0 0 1 2 3 3 4 6 8 8 9 12 11 8 10 12 9 8 8 7 7 7 7 10 14 13 9 7 7 7 5 5 6 4 2 1 
#Chair09
0 0 0 0 0 1 1 1 3 8 11 16 16 22 22 16 18 14 8 6 7 10 6 3 3 4 3 3 2 2 3 4 8 10 6 1 
#Chair08
0 0 0 0 1 1 2 2 3 5 11 14 14 21 21 19 17 15 8 8 6 8 6 5 6 4 3 5 3 4 3 4 7 8 6 2 
#Chair07
0 0 0 0 1 1 1 2 3 5 13 14 15 19 23 18 17 15 8 8 7 8 4 4 4 5 4 3 3 3 3 5 7 8 6 2 
#Chair06
0 0 0 0 0 0 1 2 3 6 12 15 17 21 22 19 15 14 7 8 6 8 6 4 4 4 3 3 5 3 3 6 7 8 7 2 
#Chair05
0 0 0 0 0 0 1 3 3 6 11 15 17 19 20 16 20 14 10 7 6 8 4 5 4 6 3 5 3 4 3 5 5 7 5 2 
#Chair04
0 0 0 0 0 1 1 2 2 5 12 16 17 22 21 16 16 12 9 7 7 7 4 4 5 5 3 3 3 3 3 5 8 10 7 3 
#Chair03
0 0 0 0 1 1 1 1 3 7 11 16 14 19 22 14 16 14 7 9 7 9 7 5 2 5 4 4 3 3 3 5 7 10 7 2 
#Chair02
0 0 0 0 1 0 2 3 4 7 11 17 17 18 23 16 17 14 8 7 6 7 7 5 4 5 3 3 3 4 3 4 4 8 5 3 
#Chair010
0 0 0 0 0 2 1 2 3 6 11 13 15 21 20 19 16 14 11 6 8 9 5 4 4 3 5 4 4 3 4 5 6 8 6 2 
#Chair01
0 0 0 0 1 1 1 1 4 6 12 13 15 22 23 16 18 14 9 9 6 7 6 4 4 4 4 4 4 3 3 6 6 7 6 2 
