#WallLamp02
0 0 0 0 0 9 19 17 14 18 16 9 8 4 8 0 0 0 0 0 0 9 5 6 8 16 15 17 15 22 10 1 0 0 0 0 
#WallLamp01
0 0 0 0 0 9 20 16 18 16 17 8 6 5 7 0 0 0 0 0 0 9 5 8 9 17 17 16 14 18 8 1 0 0 0 0 
#Screen
0 0 0 3 9 12 10 13 14 12 13 10 12 10 3 0 0 0 0 0 0 3 9 10 13 12 14 14 10 14 11 10 2 0 0 0 
#Projector
0 0 0 10 12 7 11 14 12 9 8 7 7 7 13 0 0 0 0 0 0 13 9 8 9 11 11 7 12 15 10 8 12 0 0 0 
#Desk
0 0 0 7 9 10 12 11 11 14 11 12 10 11 5 0 0 0 0 0 0 6 9 8 10 12 12 12 11 12 11 11 7 0 0 0 
#Chair05
0 0 11 11 9 10 29 0 0 0 0 0 0 0 1 4 0 0 0 0 0 5 8 11 12 15 15 11 14 17 16 18 15 12 0 0 
#Chair04
0 0 12 11 9 11 26 0 0 0 0 0 0 0 2 4 0 0 0 0 0 6 7 10 11 14 14 13 14 15 19 19 16 12 0 0 
#Chair03
0 0 13 10 8 12 25 0 0 0 0 0 0 0 1 4 0 0 0 0 0 6 10 12 12 12 12 12 14 19 18 18 16 11 0 0 
#Chair02
0 0 11 11 8 9 24 0 0 0 0 0 0 0 2 4 0 0 0 0 0 5 9 10 13 15 12 12 15 19 18 21 16 12 0 0 
#Chair01
0 0 14 10 10 12 23 0 0 0 0 0 0 0 1 4 0 0 0 0 0 6 10 12 12 13 12 12 14 19 17 19 15 12 0 0 
