#WallLamp02
10 35 48 52 46 33 20 6 0 0 
#WallLamp01
10 36 50 53 46 32 19 6 0 0 
#Screen
14 36 47 50 44 31 19 9 1 0 
#Projector
5 16 31 41 43 40 37 23 12 2 
#Desk
7 23 46 53 51 33 22 13 3 0 
#Chair05
11 29 54 52 38 26 20 13 8 1 
#Chair04
11 29 54 53 38 26 19 13 9 1 
#Chair03
11 29 55 52 36 25 20 14 9 1 
#Chair02
11 29 55 53 36 26 19 13 8 1 
#Chair01
11 30 54 51 36 25 20 14 9 1 
