#TV
0 0 0 7 13 4 4 17 30 21 5 0 0 0 0 6 11 3 0 0 0 5 11 4 4 17 30 25 4 0 0 0 0 7 10 6 
#Sofa
0 0 0 3 16 3 0 3 16 36 21 3 0 0 0 3 11 2 0 0 0 3 16 4 2 4 14 33 28 7 0 0 0 4 13 2 
#Notebook05
0 0 0 8 8 2 0 0 24 38 19 0 0 0 0 6 13 3 0 0 0 8 13 4 0 0 26 38 18 0 0 0 0 7 8 3 
#Notebook04
0 0 0 8 8 2 0 0 25 37 18 0 0 0 0 6 13 3 0 0 0 9 13 4 0 0 26 39 18 0 0 0 0 7 8 3 
#Notebook03
0 0 0 8 9 2 0 0 24 38 18 0 0 0 0 7 13 3 0 0 0 9 13 3 0 0 26 39 18 0 0 0 0 7 8 3 
#Notebook02
0 0 0 7 9 2 0 0 27 40 16 0 0 0 0 8 11 4 0 0 0 6 11 3 0 0 27 38 18 0 0 0 0 8 9 3 
#Notebook01
0 0 0 7 9 2 0 0 26 39 17 0 0 0 0 8 10 4 0 0 0 7 11 3 0 0 27 39 18 0 0 0 0 8 9 3 
#Globe
0 0 0 2 10 0 0 0 18 19 1 0 0 0 0 0 0 4 0 0 0 1 8 18 0 4 20 44 52 6 0 0 0 2 22 16 
#Desk
0 0 0 5 11 15 0 23 28 9 0 0 0 0 0 7 13 17 0 0 0 7 12 17 0 21 27 8 0 0 0 0 0 6 9 13 
#Chair09
0 0 0 7 7 4 6 23 39 30 3 0 0 0 0 0 4 3 0 0 0 0 2 2 5 23 32 35 3 2 0 0 0 8 6 2 
#Chair08
0 0 0 7 7 4 6 23 39 30 3 0 0 0 0 0 4 3 0 0 0 0 2 2 5 23 32 35 3 1 0 0 0 8 6 2 
#Chair07
0 0 0 7 7 5 4 24 33 34 2 1 0 0 0 0 5 2 0 0 0 0 4 3 5 24 35 29 3 1 0 0 0 7 5 3 
#Chair06
0 0 0 6 7 4 4 22 37 37 3 1 0 0 0 0 3 2 0 0 0 0 4 3 6 22 28 37 4 1 0 0 0 6 5 2 
#Chair05
0 0 0 6 7 4 4 22 37 37 3 1 0 0 0 0 3 2 0 0 0 0 4 2 5 21 30 36 4 1 0 0 0 7 5 2 
#Chair04
0 0 0 5 7 3 4 25 35 36 2 1 0 0 0 0 3 2 0 0 0 0 4 2 5 20 34 34 3 0 0 0 0 7 7 4 
#Chair03
0 0 0 5 6 5 4 24 35 34 4 1 0 0 0 0 3 3 0 0 0 0 5 2 4 25 33 30 3 0 0 0 0 6 7 4 
#Chair02
0 0 0 7 5 5 4 24 35 34 2 1 0 0 0 0 5 2 0 0 0 0 5 3 5 23 29 38 3 1 0 0 0 6 5 4 
#Chair013
0 0 0 9 8 5 0 1 29 48 3 1 0 0 0 3 15 6 0 0 0 4 13 6 0 1 33 44 2 0 0 0 0 10 4 1 
#Chair012
0 0 0 8 8 5 0 2 33 48 3 0 0 0 0 2 13 8 0 0 0 3 10 7 0 1 31 44 3 0 0 0 0 8 6 3 
#Chair011
0 0 0 1 2 0 0 11 37 29 7 2 0 0 0 4 11 17 0 0 0 4 14 20 0 12 37 27 6 2 0 0 0 2 1 0 
#Chair010
0 0 0 6 9 5 4 20 41 34 2 1 0 0 0 0 4 2 0 0 0 0 5 3 5 22 32 28 2 1 0 0 0 5 8 4 
#Chair01
0 0 0 5 9 5 4 20 40 34 2 1 0 0 0 0 4 2 0 0 0 0 6 3 5 22 32 29 2 1 0 0 0 6 8 4 
#Bookshelf02
0 0 0 3 12 5 2 12 30 35 2 0 0 0 0 3 13 7 0 0 0 3 10 4 5 17 24 30 4 0 0 0 0 3 15 7 
#Bookshelf01
0 0 0 2 14 8 1 14 30 35 3 0 0 0 0 2 13 6 0 0 0 3 9 7 3 18 21 28 4 0 0 0 0 2 16 6 
