#TV
0 0 0 1 10 12 13 14 14 12 11 12 10 9 2 0 0 0 0 0 0 2 9 10 14 13 12 12 14 14 9 9 4 0 0 0 
#Sofa
0 0 0 1 11 9 11 11 13 13 13 17 17 0 0 0 0 0 0 0 0 0 7 16 15 11 14 13 18 16 19 0 0 0 0 0 
#Notebook05
0 0 0 0 6 12 15 12 11 11 16 13 14 8 0 0 0 0 0 0 0 1 10 14 11 14 12 15 14 15 12 6 1 0 0 0 
#Notebook04
0 0 0 0 6 13 15 13 11 11 16 13 14 8 0 0 0 0 0 0 0 1 11 14 12 14 13 14 14 14 12 6 1 0 0 0 
#Notebook03
0 0 0 0 6 12 15 13 11 11 16 13 14 8 0 0 0 0 0 0 0 1 10 14 11 14 13 14 14 15 12 6 1 0 0 0 
#Notebook02
0 0 0 0 6 12 14 14 13 10 15 15 13 9 0 0 0 0 0 0 0 0 8 13 11 17 10 15 16 14 14 5 0 0 0 0 
#Notebook01
0 0 0 0 6 12 14 14 13 10 14 15 13 9 0 0 0 0 0 0 0 0 9 12 11 17 11 15 15 15 14 5 1 0 0 0 
#Globe
0 0 0 0 5 8 6 8 6 7 4 5 0 0 1 1 1 0 0 0 4 8 10 4 19 16 22 20 24 24 17 14 7 0 0 0 
#Desk
0 0 8 6 8 7 9 7 9 13 11 11 9 9 10 9 0 0 0 0 10 8 8 10 11 12 12 7 6 7 7 7 8 5 0 0 
#Chair09
0 0 1 3 5 8 11 15 23 20 20 12 2 3 1 0 0 0 0 0 0 1 1 2 11 22 20 22 13 12 9 4 1 1 0 0 
#Chair08
0 0 1 3 6 8 11 15 23 20 20 12 2 2 1 0 0 0 0 0 0 1 1 2 11 22 19 21 14 12 9 4 1 1 0 0 
#Chair07
0 1 1 3 5 8 10 12 23 19 23 11 4 2 1 0 0 0 0 0 0 2 2 3 10 19 20 21 16 11 8 4 2 1 0 0 
#Chair06
0 1 1 3 5 6 11 13 22 20 23 14 3 1 1 0 0 0 0 0 0 1 2 3 10 20 19 21 15 13 7 3 2 1 0 0 
#Chair05
0 1 1 3 5 7 12 12 22 20 22 14 3 2 1 0 0 0 0 0 0 1 2 3 11 20 19 21 14 13 8 3 2 1 0 0 
#Chair04
0 0 1 3 5 6 11 16 23 20 21 11 2 2 1 0 0 0 0 0 0 1 1 3 8 21 18 21 16 12 9 5 2 2 0 0 
#Chair03
0 0 1 4 4 6 10 13 22 21 24 12 3 1 2 0 0 0 0 0 0 1 2 4 8 21 23 20 13 9 7 5 2 1 0 0 
#Chair02
0 1 1 2 4 8 10 13 20 22 23 11 3 3 1 0 0 0 0 0 0 1 3 3 9 24 19 20 14 12 7 4 3 1 0 0 
#Chair013
0 0 0 0 7 15 19 23 16 6 8 10 11 10 3 0 0 0 0 0 0 2 9 11 8 4 7 15 21 24 13 3 0 0 0 0 
#Chair012
0 0 0 0 7 13 20 25 16 7 7 10 10 10 3 0 0 0 0 0 0 2 9 9 7 6 8 16 21 21 13 4 0 0 0 0 
#Chair011
0 0 0 0 1 2 11 9 11 16 21 18 13 10 6 3 0 0 0 0 1 8 12 16 18 20 15 12 10 9 2 1 0 0 0 0 
#Chair010
0 0 1 4 6 8 13 14 21 20 22 13 3 1 1 0 0 0 0 0 0 2 3 3 9 20 17 23 12 9 7 5 3 1 0 0 
#Chair01
0 0 1 4 6 7 13 14 21 19 22 13 3 1 1 0 0 0 0 0 0 1 3 3 9 20 17 23 13 9 8 6 3 1 0 0 
#Bookshelf02
0 0 0 2 9 9 16 11 12 7 22 13 7 8 7 0 0 0 0 0 0 4 4 9 14 7 17 25 6 11 9 12 5 0 0 0 
#Bookshelf01
0 0 0 5 10 9 13 11 14 8 22 15 7 7 7 0 0 0 0 0 0 6 4 9 12 8 14 24 6 10 7 12 4 0 0 0 
