#TV02
0 1 1 2 3 4 5 7 5 7 7 10 11 10 11 10 11 8 8 8 10 7 9 7 7 9 9 7 9 7 9 6 6 2 1 0 
#TV01
0 1 1 2 3 4 5 7 5 7 8 10 10 10 11 10 11 8 8 8 10 8 9 7 7 9 9 7 9 7 10 6 7 3 2 0 
#Screen
0 1 0 1 2 2 3 4 4 5 5 6 6 8 9 9 9 10 11 11 15 13 12 12 11 10 9 10 11 8 6 5 5 3 1 1 
#Projector
0 0 0 0 0 1 2 4 4 4 6 4 7 7 6 7 8 8 7 9 9 18 12 12 8 8 9 10 9 13 10 8 8 10 8 2 
#Notebook02
0 0 0 0 0 0 0 0 0 0 0 3 3 7 10 14 16 14 16 17 15 14 14 15 15 14 10 10 10 10 7 4 3 2 0 0 
#Notebook01
0 0 0 0 0 0 0 0 0 0 0 2 4 8 12 13 16 18 17 13 13 14 14 16 14 13 11 11 8 8 7 7 4 2 1 1 
#Desk
0 1 0 2 4 5 5 6 5 9 10 9 10 14 13 8 8 10 10 11 9 8 9 7 8 7 5 6 6 6 4 7 6 6 3 1 
#Cup
0 0 0 0 0 0 0 0 0 0 0 0 0 7 13 12 18 19 11 11 15 15 15 14 16 11 9 5 3 3 4 5 7 14 12 4 
#Chair09
0 0 0 0 0 0 0 0 0 4 6 14 13 12 16 14 16 17 22 15 13 9 6 6 6 7 5 6 6 4 5 4 7 4 2 2 
#Chair08
0 0 0 0 0 0 0 0 1 5 5 11 14 13 13 15 16 17 18 18 15 8 7 5 6 7 7 5 6 5 6 5 7 5 2 0 
#Chair07
0 0 0 0 0 0 0 0 1 6 7 14 14 12 14 12 16 18 15 17 16 9 6 5 6 7 7 6 5 4 6 7 5 4 3 2 
#Chair06
0 0 0 0 0 0 0 0 1 5 6 14 14 11 14 13 13 16 19 15 12 10 9 6 6 8 7 7 7 4 6 6 6 5 3 1 
#Chair05
0 0 0 0 0 0 0 0 1 5 6 13 14 12 16 14 13 17 18 16 12 8 7 5 7 7 6 7 5 6 3 7 6 7 3 1 
#Chair04
0 0 0 0 0 0 0 0 0 5 7 12 14 12 11 11 14 14 25 15 12 9 9 7 7 7 5 6 7 5 5 6 7 4 3 1 
#Chair03
0 0 0 0 0 0 0 0 0 3 9 12 14 11 12 12 17 19 21 15 14 9 8 6 6 6 6 6 5 4 6 6 7 4 3 1 
#Chair02
0 0 0 0 0 0 0 0 0 5 7 12 13 13 13 13 14 17 19 17 14 9 7 5 6 5 8 8 6 5 5 5 7 6 3 1 
#Chair01
0 0 0 0 0 0 0 0 1 5 9 12 12 9 12 14 14 18 18 14 12 9 9 7 7 8 8 6 6 7 4 6 6 6 3 0 
#CellingLight04
0 0 0 1 1 2 2 1 3 3 3 3 4 6 5 4 4 7 6 5 6 6 6 7 8 8 10 7 8 12 12 11 16 10 10 41 
#CellingLight03
0 0 0 1 1 1 2 2 3 2 3 4 3 6 4 6 6 6 7 6 6 7 6 7 9 10 10 8 8 11 10 11 15 11 9 40 
#CellingLight02
0 0 0 1 1 1 2 2 3 2 4 4 4 4 4 5 5 6 6 6 7 8 7 6 9 8 10 9 8 10 10 11 14 11 11 38 
#CellingLight01
0 0 0 1 1 2 2 2 2 3 4 4 4 4 5 4 4 5 5 6 6 8 6 7 8 9 9 9 11 9 9 11 15 9 11 44 
#Book
0 1 2 1 3 3 5 5 4 6 6 10 8 8 11 11 10 12 9 9 9 11 8 9 8 11 8 8 9 8 9 7 5 3 1 0 
