#TV
0 0 1 2 4 3 3 4 4 5 8 6 8 8 9 11 10 11 12 12 14 9 8 8 8 8 8 8 7 8 9 8 5 4 3 2 
#Picture
0 0 0 1 1 2 1 2 5 7 13 7 8 7 8 11 13 9 8 9 8 8 7 11 10 12 8 9 9 9 11 9 10 4 2 1 
#Desk
0 0 1 2 3 4 6 4 5 5 8 9 9 10 11 12 8 13 10 14 10 10 11 11 10 12 9 6 5 7 4 3 3 3 1 0 
#CordedPhone
0 0 1 1 2 4 3 4 3 4 6 7 7 9 10 9 10 11 10 13 13 12 12 12 14 10 10 11 12 8 5 4 2 1 0 0 
#Chair06
0 0 0 0 1 3 3 4 5 6 7 9 8 9 11 12 11 11 12 15 14 12 10 7 8 10 8 7 7 6 6 5 5 4 3 1 
#Chair05
0 0 0 0 1 3 3 5 8 4 4 7 8 10 12 13 11 9 11 13 16 11 9 7 6 11 8 5 8 6 7 6 6 6 4 1 
#Chair04
0 0 0 0 1 2 3 4 7 6 8 7 7 9 11 11 11 8 11 15 13 13 9 7 7 10 8 8 4 6 7 6 5 6 3 1 
#Chair03
0 0 0 0 1 2 1 6 5 8 5 7 8 8 13 14 10 12 11 14 12 11 8 7 5 10 9 6 7 5 6 5 6 7 4 2 
#Chair02
0 0 1 0 1 2 2 4 5 7 6 9 9 8 12 16 9 10 11 12 12 13 9 7 7 10 6 7 6 8 5 7 4 6 3 2 
#Chair01
0 0 0 1 1 3 3 5 7 5 5 7 10 8 10 13 9 9 12 14 16 11 9 7 7 9 8 7 6 6 6 6 7 8 4 2 
#Camera
0 0 0 1 2 2 5 6 7 9 7 12 12 12 15 14 13 10 10 9 9 8 7 7 6 7 9 7 5 6 4 6 6 4 2 0 
