#TV
0 0 0 9 9 8 11 11 14 13 14 10 9 7 9 0 0 0 0 0 0 7 8 9 13 12 13 12 12 11 8 8 8 0 0 0 
#Picture
0 0 3 8 9 10 9 8 11 12 11 9 11 9 8 2 0 0 0 0 3 9 9 9 11 11 11 12 8 10 8 9 7 3 0 0 
#Desk
0 0 1 2 4 11 11 14 12 10 14 11 10 7 3 1 0 0 0 0 1 4 13 9 14 18 7 10 19 11 15 2 3 2 0 0 
#CordedPhone
0 0 0 0 8 14 14 13 20 18 20 16 14 6 1 0 0 0 0 0 0 0 3 11 10 11 11 12 9 6 13 13 5 0 0 0 
#Chair06
0 0 2 2 8 11 4 17 21 18 12 11 7 6 3 4 0 0 0 0 3 3 6 5 8 11 17 21 16 2 13 7 4 0 0 0 
#Chair05
0 0 1 5 8 13 4 15 23 19 13 7 7 6 4 5 0 0 0 0 5 4 4 7 8 14 14 21 15 2 9 7 3 1 0 0 
#Chair04
0 0 1 4 7 12 4 16 23 16 13 8 6 7 3 3 0 0 0 0 4 4 6 6 9 15 12 23 13 1 13 6 4 1 0 0 
#Chair03
0 0 2 5 9 10 5 15 21 13 15 9 5 4 4 5 0 0 0 0 5 3 5 8 9 16 17 21 12 2 9 7 3 1 0 0 
#Chair02
0 0 1 4 7 13 4 16 23 17 15 7 6 5 4 4 0 0 0 0 4 3 6 6 9 13 16 19 15 2 10 8 2 1 0 0 
#Chair01
0 0 2 3 11 13 5 15 21 15 13 11 6 4 5 6 0 0 0 0 4 3 4 4 8 13 14 22 16 2 11 6 4 1 0 0 
#Camera
0 0 0 0 0 2 9 21 22 24 21 11 5 6 5 1 0 0 0 0 1 3 3 2 12 23 22 25 20 7 0 0 0 0 0 0 
