#TV
0 0 0 6 12 9 5 15 27 25 1 0 0 0 0 6 11 9 0 0 0 4 12 7 6 17 31 19 0 0 0 0 0 5 11 7 
#Picture
0 0 0 7 15 9 1 18 29 13 0 0 0 0 0 6 15 9 0 0 0 6 14 11 3 19 29 14 0 0 0 0 0 6 14 8 
#Desk
0 0 0 7 8 3 7 18 34 15 0 0 0 0 0 6 12 4 0 0 0 6 18 4 4 20 32 25 1 0 0 0 0 7 11 4 
#CordedPhone
0 0 0 3 14 4 3 12 37 35 10 1 0 0 0 7 12 2 0 0 0 4 10 0 5 16 21 15 2 0 0 0 0 7 17 6 
#Chair06
0 0 0 4 12 7 3 20 33 26 1 0 0 0 0 5 8 7 0 0 0 4 8 6 3 17 30 25 0 0 0 0 0 5 15 5 
#Chair05
0 0 0 6 14 8 3 20 32 23 2 0 0 0 0 6 8 9 0 0 0 5 8 9 2 14 33 24 0 0 0 0 0 4 12 5 
#Chair04
0 0 0 6 12 8 3 21 31 25 1 0 0 0 0 4 8 7 0 0 0 4 8 8 3 17 28 25 0 0 0 0 0 5 14 5 
#Chair03
0 0 0 3 14 10 2 18 33 23 2 0 0 0 0 4 7 9 0 0 0 6 8 8 2 17 33 25 0 0 0 0 0 4 12 5 
#Chair02
0 0 0 5 13 8 3 19 36 23 2 0 0 0 0 4 8 8 0 0 0 4 8 7 3 17 29 25 0 0 0 0 0 4 12 5 
#Chair01
0 0 0 5 15 10 4 14 33 27 3 0 0 0 0 4 7 10 0 0 0 3 6 7 3 19 29 25 0 0 0 0 0 5 11 6 
#Camera
0 0 0 0 1 1 2 24 38 24 14 6 0 0 0 2 8 8 0 0 0 2 5 2 3 24 40 23 14 6 0 0 0 0 0 0 
