#TV
13 34 45 47 42 30 21 14 6 0 
#Desk
17 42 52 46 34 23 17 12 8 2 
#Chair09
12 40 59 67 43 19 8 3 1 0 
#Chair08
12 39 58 67 44 20 8 3 1 0 
#Chair07
12 37 57 67 44 21 9 4 1 0 
#Chair06
12 38 58 66 43 20 9 4 1 0 
#Chair05
12 37 58 66 44 21 10 4 1 0 
#Chair04
12 38 57 66 44 20 9 4 1 0 
#Chair03
13 38 57 68 44 20 8 4 1 0 
#Chair02
12 39 58 66 43 20 8 4 1 0 
#Chair010
12 38 59 66 43 20 8 4 1 0 
#Chair01
12 38 57 66 44 21 8 4 1 0 
#Cabinet
8 27 48 53 35 27 22 16 10 4 
#Bonsai02
31 64 28 23 29 30 23 16 6 0 
#Bonsai01
31 64 28 23 28 30 23 17 7 0 
