#TV
0 0 0 11 8 11 11 12 10 10 10 11 8 7 12 0 0 0 0 0 0 13 8 10 9 12 11 11 12 11 9 7 9 0 0 0 
#Desk
0 0 8 6 5 5 7 8 12 12 9 11 8 9 7 6 0 0 0 0 8 8 10 11 12 12 15 12 11 7 7 3 6 6 0 0 
#Chair09
0 0 0 1 3 8 5 15 38 14 20 6 4 3 3 2 1 0 0 2 3 2 3 4 2 17 14 33 18 7 8 5 1 0 0 0 
#Chair08
0 0 0 1 3 7 7 14 34 16 19 4 4 4 2 2 0 0 0 1 2 3 4 5 5 17 15 35 14 5 10 4 1 0 0 0 
#Chair07
0 0 0 1 4 10 8 18 30 17 18 5 4 4 3 3 0 0 0 1 3 2 4 4 4 16 14 33 15 4 10 3 2 0 0 0 
#Chair06
0 0 0 1 5 8 6 17 34 15 19 4 5 4 2 3 1 0 0 0 2 4 3 4 4 15 16 30 15 7 12 4 1 0 0 0 
#Chair05
0 0 0 1 5 8 6 17 28 11 19 7 5 3 2 2 0 0 0 2 3 3 3 5 5 16 17 32 16 8 10 4 1 0 0 0 
#Chair04
0 0 0 1 4 8 5 16 31 17 17 4 6 4 3 2 1 0 0 0 3 3 3 4 5 20 15 31 16 6 11 5 1 0 0 0 
#Chair03
0 0 0 1 4 9 5 16 34 16 17 4 3 3 3 3 1 0 0 1 2 2 4 4 4 17 17 36 14 5 9 5 1 0 0 0 
#Chair02
0 0 0 1 4 9 7 15 33 13 20 4 6 4 3 2 1 0 0 1 2 3 3 5 4 19 16 32 13 7 9 3 2 0 0 0 
#Chair010
0 0 0 0 4 10 7 16 32 15 19 5 5 3 4 3 1 0 0 1 4 3 2 4 6 14 16 36 12 7 9 4 0 0 0 0 
#Chair01
0 0 0 1 3 9 5 16 34 12 18 4 5 3 3 3 1 0 0 1 3 4 3 4 4 18 16 35 16 5 9 4 1 0 0 0 
#Cabinet
0 0 11 7 6 11 12 11 13 12 9 15 11 8 7 12 0 0 0 0 12 5 4 7 8 7 8 7 7 7 6 6 4 10 0 0 
#Bonsai02
0 0 0 0 7 8 17 22 22 12 7 6 7 30 15 12 17 0 0 6 7 7 11 0 0 0 0 6 5 3 7 6 3 1 0 0 
#Bonsai01
0 0 0 0 6 7 17 22 21 12 7 7 8 31 15 12 16 0 0 6 7 6 10 0 0 0 0 5 5 3 7 6 4 1 0 0 
