#TV
0 0 1 0 2 1 3 3 6 6 6 6 6 7 8 6 12 12 11 11 10 9 9 9 9 8 10 8 10 14 14 10 7 2 1 1 
#Desk
0 0 0 0 3 5 5 6 8 6 10 16 13 9 7 8 9 8 7 6 7 7 6 7 6 7 7 6 7 8 6 8 8 11 9 5 
#Chair09
0 0 0 0 0 1 2 2 2 6 12 17 22 25 26 23 12 12 8 8 4 2 3 4 4 5 5 4 5 3 3 2 4 3 4 3 
#Chair08
0 0 0 1 1 1 3 1 3 5 13 16 19 22 26 23 14 9 10 10 5 2 4 4 4 5 8 5 3 4 2 2 4 4 3 2 
#Chair07
0 0 0 0 1 1 1 1 3 6 11 16 20 23 25 23 16 12 9 9 4 2 3 6 4 7 7 4 4 4 3 4 5 3 4 1 
#Chair06
0 0 0 1 1 1 1 2 3 7 10 17 20 24 26 23 13 11 6 6 5 3 5 3 5 6 7 4 5 4 4 3 4 4 5 1 
#Chair05
0 0 0 0 1 1 1 1 2 6 10 15 21 24 25 20 13 11 10 8 6 3 3 5 5 6 6 6 4 3 3 4 3 4 5 2 
#Chair04
0 0 0 1 1 1 1 2 1 7 11 15 23 22 25 22 11 14 8 9 6 2 3 7 5 6 7 5 3 4 3 3 3 4 3 2 
#Chair03
0 0 0 0 1 1 1 2 2 6 12 15 25 23 25 22 14 11 7 11 4 2 3 3 6 6 6 5 3 3 4 3 4 3 3 3 
#Chair02
0 0 0 0 0 1 3 2 2 5 10 16 21 25 26 23 12 10 10 8 3 4 4 3 5 6 7 5 3 3 4 4 3 4 3 2 
#Chair010
0 0 0 1 1 0 2 1 3 6 11 16 19 23 26 23 16 11 8 8 6 2 3 5 6 6 7 4 3 3 3 3 2 4 5 3 
#Chair01
0 0 0 0 1 1 2 2 1 7 12 19 19 22 23 23 13 13 8 9 5 2 4 6 4 5 6 6 2 4 4 3 3 4 4 2 
#Cabinet
0 0 0 0 0 0 0 1 3 4 5 10 10 13 9 9 9 9 9 10 9 8 8 9 6 7 6 6 6 6 6 7 16 24 13 2 
#Bonsai02
0 0 3 3 6 8 10 7 8 6 5 6 4 6 6 5 5 5 3 4 4 6 4 4 4 5 10 26 12 8 8 6 7 9 10 16 
#Bonsai01
0 0 2 3 6 8 10 7 8 7 5 6 4 6 6 5 5 5 3 4 4 6 4 4 5 5 10 27 12 8 8 7 7 9 10 15 
