#TV
13 33 43 48 46 34 21 11 4 0 
#Speaker02
4 15 29 39 49 50 39 22 5 0 
#Speaker01
4 15 28 38 48 50 40 22 5 0 
#Desk
22 54 49 41 30 22 18 12 4 0 
#Chair09
9 22 39 53 53 37 20 13 4 0 
#Chair08
9 23 40 54 53 37 20 12 4 0 
#Chair07
9 22 39 53 53 37 22 13 4 0 
#Chair06
9 22 38 52 53 37 22 13 5 0 
#Chair05
9 22 39 52 53 37 22 13 5 0 
#Chair04
9 23 40 54 53 37 20 12 4 0 
#Chair03
9 23 40 55 53 37 20 12 4 0 
#Chair02
9 23 40 54 53 37 20 11 4 0 
#Chair014
9 23 40 54 53 37 20 12 4 0 
#Chair013
9 23 39 54 52 36 21 13 4 0 
#Chair012
9 23 39 54 52 36 21 13 4 0 
#Chair011
9 23 39 54 52 36 21 13 4 0 
#Chair010
9 23 39 54 52 37 21 12 4 0 
#Chair01
9 22 39 53 53 37 21 13 4 0 
#Carpet
17 41 51 49 37 26 18 10 3 0 
