#TV
0 0 0 5 8 10 14 16 14 11 14 14 9 8 7 0 0 0 0 0 0 9 8 8 12 10 10 10 11 10 9 8 8 0 0 0 
#Speaker02
0 0 0 0 18 8 11 12 11 9 12 15 15 17 0 0 0 0 0 0 0 0 18 11 14 12 10 10 10 7 7 18 0 0 0 0 
#Speaker01
0 0 0 0 21 7 10 9 12 12 12 14 12 17 0 0 0 0 0 0 0 0 16 13 14 13 10 9 9 8 9 19 0 0 0 0 
#Desk
0 1 2 4 11 10 8 9 14 14 9 7 12 9 4 3 2 0 0 1 3 4 10 11 8 9 13 13 8 8 12 10 4 2 1 0 
#Chair09
0 0 2 4 5 7 7 9 32 15 2 3 19 12 4 1 0 0 0 0 1 5 12 19 3 2 13 28 8 9 5 7 4 3 0 0 
#Chair08
0 0 2 4 6 6 7 9 31 16 2 3 20 12 4 1 0 0 0 0 1 5 12 19 3 2 12 29 8 9 5 7 4 3 0 0 
#Chair07
0 0 2 2 6 6 7 6 27 15 1 3 20 9 5 1 0 0 0 0 2 8 11 21 4 1 14 30 9 7 10 6 4 3 0 0 
#Chair06
0 0 1 6 9 18 3 2 15 27 7 7 6 5 2 2 0 0 0 0 3 4 6 10 7 9 30 13 1 4 22 11 8 2 0 0 
#Chair05
0 0 1 6 9 20 2 1 15 27 7 7 6 5 2 2 0 0 0 0 3 4 6 10 7 10 29 14 1 4 20 11 9 2 0 0 
#Chair04
0 0 1 4 11 16 3 1 18 28 8 5 9 5 3 2 0 0 0 0 3 4 6 7 7 11 30 14 2 3 22 9 6 1 0 0 
#Chair03
0 0 1 4 12 16 3 1 19 29 8 5 9 5 4 2 0 0 0 0 3 4 6 7 7 11 29 15 2 4 21 9 5 1 0 0 
#Chair02
0 0 1 4 11 16 3 1 19 29 8 6 9 5 4 2 0 0 0 0 3 4 6 7 7 11 30 14 2 3 22 9 5 1 0 0 
#Chair014
0 0 2 3 5 9 6 7 29 19 1 3 17 11 4 1 0 0 0 0 1 6 9 22 3 2 14 30 11 7 7 6 4 3 0 0 
#Chair013
0 0 2 4 7 6 8 6 30 14 2 3 20 11 5 1 0 0 0 0 1 5 10 20 4 1 13 29 9 7 7 6 4 2 0 0 
#Chair012
0 0 2 4 7 6 8 6 30 14 2 3 20 11 4 1 0 0 0 0 1 5 11 20 4 1 14 29 9 7 7 6 4 2 0 0 
#Chair011
0 0 2 4 7 6 8 7 30 14 2 3 20 12 5 1 0 0 0 0 1 5 11 20 4 1 14 28 9 7 7 6 4 2 0 0 
#Chair010
0 0 2 4 7 6 8 7 30 15 2 3 20 11 4 1 0 0 0 0 1 5 11 20 4 1 14 29 9 7 7 6 4 2 0 0 
#Chair01
0 0 1 6 10 23 3 1 17 31 7 7 7 5 4 3 0 0 0 0 3 4 8 6 6 6 28 15 1 2 19 12 5 1 0 0 
#Carpet
0 0 1 7 6 10 9 11 11 14 13 13 10 9 7 1 0 0 0 0 1 6 9 10 12 10 12 12 9 12 11 8 6 1 0 0 
