#Desk
0 1 5 7 6 5 7 7 7 10 10 7 9 8 8 7 8 7 6 7 8 5 6 6 7 7 5 8 11 9 9 6 6 6 5 1 
#Chair09
0 0 0 0 5 5 6 7 7 7 11 11 11 15 14 19 13 8 9 9 10 7 6 7 6 3 4 3 5 2 3 4 7 7 5 2 
#Chair08
0 0 0 0 3 5 5 6 5 7 10 10 12 14 18 18 14 9 8 11 7 8 6 6 6 5 3 3 5 3 3 4 6 9 7 4 
#Chair07
0 0 0 0 2 3 6 5 6 8 10 10 11 15 17 19 12 11 8 11 7 7 6 6 5 5 5 4 3 3 4 4 8 8 7 3 
#Chair06
0 0 0 0 3 5 8 6 5 6 9 9 10 14 17 17 14 14 10 9 9 6 5 6 6 4 3 4 5 4 2 5 7 7 8 3 
#Chair05
0 0 0 0 4 3 5 6 8 9 9 11 9 13 16 17 14 9 9 10 10 6 8 7 6 4 4 3 4 2 4 5 8 8 7 2 
#Chair04
0 0 0 0 3 4 4 7 8 8 8 10 10 14 15 15 13 12 9 11 8 7 6 7 6 4 3 4 4 3 4 5 7 7 7 3 
#Chair03
0 0 0 0 2 4 3 6 5 7 11 10 11 14 18 17 12 14 11 9 10 7 5 6 6 4 5 4 3 5 3 5 6 6 6 4 
#Chair02
0 0 0 0 5 4 5 8 5 9 10 11 8 15 17 19 13 10 10 10 9 5 5 5 4 4 4 3 3 4 3 4 7 7 8 4 
#Chair012
0 0 0 0 2 6 5 6 7 5 7 10 12 17 18 18 12 12 11 10 10 6 7 6 5 4 3 3 2 3 4 4 7 8 6 3 
#Chair011
0 0 0 0 3 7 6 6 6 7 8 9 11 14 18 18 12 9 9 10 10 7 5 5 7 4 4 3 5 3 4 4 5 6 9 2 
#Chair010
0 0 0 0 4 4 6 4 7 8 9 10 10 16 15 19 14 12 9 11 9 6 5 6 6 5 4 5 4 4 3 4 7 8 6 4 
#Chair01
0 0 0 0 4 5 5 6 7 6 8 10 12 16 15 16 13 13 8 7 10 6 5 7 7 5 4 4 4 4 2 4 7 7 9 4 
#Cabinet
0 0 0 0 0 3 3 4 4 6 12 16 18 14 12 9 6 6 6 7 8 5 7 6 6 6 5 8 7 4 6 6 7 9 18 5 
