#Desk
13 39 46 42 33 25 31 18 3 0 
#Chair08
11 30 44 54 55 36 16 5 1 0 
#Chair07
11 30 43 54 54 36 17 5 1 0 
#Chair06
10 31 43 54 54 36 17 5 1 0 
#Chair05
11 30 44 54 53 35 17 6 1 0 
#Chair04
10 30 44 53 53 36 17 6 1 0 
#Chair03
10 30 43 53 54 37 17 6 1 0 
#Chair02
11 31 45 54 53 34 16 6 1 0 
#Chair01
11 31 44 54 54 35 16 5 1 0 
