#Desk
0 0 2 4 6 25 6 7 8 9 7 7 26 7 5 1 0 0 0 0 3 4 5 24 6 9 9 7 9 6 24 9 4 2 0 0 
#Chair08
0 0 0 2 2 7 11 14 16 13 20 19 11 5 3 0 0 0 0 0 0 4 6 9 17 19 12 18 14 18 2 2 1 0 0 0 
#Chair07
0 0 0 2 3 5 13 14 16 15 18 18 11 7 4 0 0 0 0 0 0 4 7 9 17 17 13 14 15 14 3 2 1 0 0 0 
#Chair06
0 0 0 1 1 7 14 13 17 16 17 19 9 5 4 0 0 0 0 0 0 5 8 10 18 17 15 16 12 13 3 2 1 0 0 0 
#Chair05
0 0 0 2 2 4 10 14 19 16 19 18 11 6 4 0 0 0 0 0 0 5 7 10 17 18 12 15 12 14 5 2 2 0 0 0 
#Chair04
0 0 0 2 2 4 11 14 18 14 18 22 11 6 3 0 0 0 0 0 0 6 7 9 17 14 12 17 15 14 4 3 1 0 0 0 
#Chair03
0 0 0 2 2 4 13 14 17 13 16 19 9 5 3 0 0 0 0 0 0 5 6 11 18 16 16 16 16 15 4 2 2 0 0 0 
#Chair02
0 0 0 2 1 5 11 14 16 15 20 17 10 6 4 0 0 0 0 0 0 5 8 10 23 16 13 16 12 14 3 2 1 0 0 0 
#Chair01
0 0 0 2 2 4 14 13 20 16 18 19 7 6 5 0 0 0 0 0 0 6 7 11 18 15 15 14 14 14 3 2 1 0 0 0 
