#TV
0 0 0 5 7 11 9 16 19 17 14 11 10 7 7 0 0 0 0 0 0 4 8 10 11 12 10 10 11 11 10 8 6 0 0 0 
#Table
0 0 5 13 4 5 7 6 9 8 10 7 9 7 11 5 0 0 0 0 4 15 9 8 11 12 11 9 11 9 9 8 13 7 0 0 
#Sofa
0 0 4 11 10 10 13 13 19 15 14 11 12 12 12 3 0 0 0 0 4 5 6 8 9 9 12 5 4 6 6 6 4 1 0 0 
#Desk
0 1 3 3 7 10 9 9 14 15 12 13 12 8 6 2 1 0 0 2 2 4 7 10 9 10 10 11 11 11 11 7 3 3 1 0 
#Chair09
0 0 1 2 3 3 3 6 13 18 22 21 17 11 5 1 0 0 0 0 0 5 9 17 19 19 13 14 8 3 3 3 2 1 0 0 
#Chair08
0 0 2 2 3 4 4 7 10 16 19 21 17 8 3 1 0 0 0 0 1 4 9 17 23 20 14 14 8 5 3 4 3 1 0 0 
#Chair07
0 0 2 2 3 4 5 6 10 15 19 20 17 8 3 1 0 0 0 0 0 4 9 18 23 20 14 14 8 5 3 4 2 1 0 0 
#Chair06
0 0 1 1 3 4 4 6 14 15 15 25 16 9 4 1 0 0 0 0 0 3 9 15 22 21 17 14 7 4 4 3 2 1 0 0 
#Chair05
0 1 1 2 4 4 6 6 10 14 17 19 18 10 3 1 0 0 0 0 1 4 9 18 21 23 15 14 9 3 2 3 2 2 0 0 
#Chair04
0 0 0 3 3 3 4 7 12 17 20 21 16 9 2 2 0 0 0 0 0 4 10 19 19 20 14 14 8 3 3 3 2 2 0 0 
#Chair03
0 0 0 3 3 3 4 7 12 18 20 20 16 9 2 2 0 0 0 0 0 4 9 19 19 20 14 14 8 3 3 3 2 2 0 0 
#Chair02
0 0 1 2 3 3 3 6 14 15 23 20 17 11 5 1 0 0 0 0 1 3 8 15 19 23 15 11 8 4 4 2 2 1 0 0 
#Chair014
0 0 1 1 3 5 4 7 10 14 17 22 17 9 4 1 0 0 0 0 0 6 11 17 21 22 15 13 10 4 3 3 1 1 0 0 
#Chair013
0 0 1 2 3 4 3 7 12 14 17 20 15 10 3 1 0 0 0 0 0 3 8 17 20 23 16 15 9 3 4 3 3 1 0 0 
#Chair012
0 0 1 2 3 4 4 7 13 14 17 20 16 11 3 1 0 0 0 0 0 3 8 16 20 24 16 16 9 3 4 3 3 1 0 0 
#Chair011
0 0 1 1 3 3 3 6 12 15 20 22 17 9 4 1 0 0 0 0 1 5 12 15 24 22 16 12 7 3 4 2 2 1 0 0 
#Chair010
0 0 1 2 3 4 5 8 12 17 16 22 16 13 3 1 0 0 0 0 0 4 8 18 18 23 14 12 8 4 3 3 1 1 0 0 
#Chair01
0 0 1 2 3 5 5 6 12 15 19 23 15 9 3 1 0 0 0 0 0 4 7 16 19 22 14 15 8 5 5 4 2 1 0 0 
