#TV
14 35 46 49 45 33 19 9 2 0 
#Table
8 24 38 47 44 30 23 18 16 1 
#Sofa
11 39 50 49 39 26 18 13 6 0 
#Desk
20 60 50 38 30 23 16 10 4 1 
#Chair09
5 20 40 51 53 43 26 10 3 0 
#Chair08
5 20 40 50 52 44 27 11 2 0 
#Chair07
5 20 40 50 52 44 27 11 2 0 
#Chair06
5 20 40 51 53 44 27 10 2 0 
#Chair05
5 19 38 49 52 45 29 12 3 0 
#Chair04
5 20 40 50 53 44 26 10 2 0 
#Chair03
5 20 40 51 53 44 26 10 2 0 
#Chair02
5 20 40 50 53 44 27 10 2 0 
#Chair014
5 19 39 50 53 45 28 10 2 0 
#Chair013
4 19 38 49 53 45 29 11 3 0 
#Chair012
4 19 38 50 53 45 28 11 3 0 
#Chair011
5 20 40 50 53 44 26 10 2 0 
#Chair010
4 20 40 50 53 44 27 10 3 0 
#Chair01
5 19 41 51 53 43 27 10 2 0 
