#Desk
12 29 33 38 44 39 28 19 9 1 
#Chair09
11 35 56 60 44 26 12 5 2 0 
#Chair08
11 35 56 60 43 25 12 6 2 0 
#Chair07
11 36 58 61 43 25 11 5 2 0 
#Chair06
11 35 55 60 43 26 12 6 3 0 
#Chair05
11 36 58 61 43 25 11 5 2 0 
#Chair04
11 36 58 62 44 24 11 5 2 0 
#Chair03
11 35 56 60 44 26 11 5 2 0 
#Chair02
11 34 56 62 44 26 12 5 2 0 
#Chair010
11 36 58 61 44 24 11 5 2 0 
#Chair01
11 35 57 60 43 26 11 5 2 0 
