#Desk
0 0 0 5 14 16 0 7 21 26 4 0 0 0 0 5 14 12 0 0 0 5 14 12 0 5 22 30 4 0 0 0 0 5 14 13 
#Chair09
0 0 0 4 3 7 1 19 55 11 0 0 0 0 0 6 7 11 0 0 0 4 6 9 1 19 53 13 0 0 0 0 0 4 4 8 
#Chair08
0 0 0 6 4 7 2 17 52 13 0 0 0 0 0 7 7 8 0 0 0 5 7 9 2 18 56 10 0 0 0 0 0 5 3 7 
#Chair07
0 0 0 5 3 7 1 19 54 12 1 0 0 0 0 3 7 11 0 0 0 6 7 8 0 21 53 12 1 0 0 0 0 4 4 6 
#Chair06
0 0 0 4 4 8 1 19 55 12 0 0 0 0 0 6 8 9 0 0 0 4 7 9 1 20 51 10 0 0 0 0 0 4 2 9 
#Chair05
0 0 0 5 4 8 1 19 52 11 0 0 0 0 0 4 7 10 0 0 0 5 5 7 2 22 56 12 0 0 0 0 0 3 3 7 
#Chair04
0 0 0 4 4 7 1 21 53 12 0 0 0 0 0 6 6 7 0 0 0 5 7 7 1 18 58 11 0 0 0 0 0 6 3 7 
#Chair03
0 0 0 4 4 6 2 20 54 12 1 0 0 0 0 3 9 9 0 0 0 5 7 11 0 19 54 12 0 0 0 0 0 4 2 6 
#Chair02
0 0 0 4 3 7 0 21 54 13 1 0 0 0 0 4 9 8 0 0 0 3 7 9 1 19 52 13 0 0 0 0 0 6 3 8 
#Chair010
0 0 0 5 2 7 1 20 52 13 0 0 0 0 0 5 7 8 0 0 0 6 7 8 1 20 55 13 0 0 0 0 0 4 2 6 
#Chair01
0 0 0 6 3 9 1 21 52 12 1 0 0 0 0 5 6 10 0 0 0 4 7 11 1 20 55 10 0 0 0 0 0 4 3 5 
