#Desk
0 0 0 0 0 0 0 0 1 3 3 3 4 4 5 8 10 10 12 16 12 14 13 9 10 12 10 10 11 12 16 12 9 7 4 3 
#Chair09
0 0 0 0 1 1 1 2 3 6 11 13 15 20 25 15 16 15 9 8 7 9 4 5 4 4 3 3 4 3 3 6 7 8 6 3 
#Chair08
0 0 0 0 2 1 1 2 2 4 11 14 19 20 22 14 17 14 9 8 7 10 6 6 4 4 3 3 4 3 3 3 7 9 6 2 
#Chair07
0 0 0 0 0 1 2 2 4 7 12 13 15 24 21 14 16 15 11 7 9 8 4 4 3 3 5 4 4 3 4 4 6 7 7 3 
#Chair06
0 0 0 0 1 1 1 1 3 5 11 16 16 22 21 17 16 13 8 7 7 8 5 5 5 2 2 3 5 4 3 7 6 8 7 3 
#Chair05
0 0 0 0 1 1 1 3 3 6 12 15 17 20 22 17 15 15 8 9 6 10 5 3 3 3 3 3 3 3 3 5 6 9 7 2 
#Chair04
0 0 0 0 1 1 1 2 4 7 12 11 16 20 20 18 18 16 9 8 8 9 6 4 5 4 4 2 3 2 2 5 6 8 5 2 
#Chair03
0 0 0 0 1 1 1 2 4 5 11 14 19 23 22 13 15 13 9 7 8 8 5 3 3 4 6 4 3 4 3 5 7 8 5 2 
#Chair02
0 0 0 0 0 1 1 2 3 6 13 13 14 20 22 13 19 16 8 8 8 8 5 3 4 4 4 4 4 3 4 4 8 7 7 2 
#Chair010
0 0 0 0 1 1 2 2 3 5 11 15 20 19 23 15 15 14 9 11 9 7 6 5 3 4 4 3 4 2 2 4 7 7 6 3 
#Chair01
0 0 0 0 1 1 2 2 4 7 11 13 17 20 22 15 17 15 8 7 8 7 6 4 3 3 2 4 3 4 4 4 7 9 9 1 
