#Desk
0 0 3 7 12 12 9 13 9 9 9 8 10 12 6 2 0 0 0 0 3 6 11 11 10 11 10 9 11 10 9 13 6 3 0 0 
#Chair09
0 0 0 1 3 8 7 19 24 17 12 7 7 5 5 6 0 0 0 0 4 5 5 5 9 12 17 21 19 8 9 3 2 1 0 0 
#Chair08
0 0 1 2 3 11 6 18 21 16 15 8 8 5 5 4 0 0 0 0 4 5 5 6 9 13 14 24 19 6 9 3 2 1 0 0 
#Chair07
0 0 1 1 3 10 7 17 23 18 12 10 4 5 4 6 0 0 0 0 4 4 4 7 7 13 18 24 17 7 9 2 1 0 0 0 
#Chair06
0 0 0 2 5 8 8 18 22 19 13 7 7 6 5 4 0 0 0 1 4 6 4 5 7 12 15 24 18 6 7 2 3 1 0 0 
#Chair05
0 0 0 1 4 12 7 17 23 16 12 8 5 5 6 5 0 0 0 1 4 3 3 6 9 15 21 22 19 7 7 3 1 1 0 0 
#Chair04
0 0 0 2 4 9 6 16 26 17 15 7 7 4 2 4 0 0 0 0 2 5 3 7 8 13 18 23 20 5 10 3 2 1 0 0 
#Chair03
0 0 0 1 3 9 6 19 26 17 15 6 4 7 5 4 0 0 0 0 4 5 6 6 6 13 17 23 20 6 9 2 1 1 0 0 
#Chair02
0 0 1 2 3 8 6 20 23 18 11 9 6 5 5 3 0 0 0 0 4 5 5 4 6 14 17 23 17 7 11 3 2 1 0 0 
#Chair010
0 0 1 1 3 9 5 19 22 17 14 8 6 5 4 4 0 0 0 0 4 4 6 6 7 16 19 22 19 6 7 3 2 0 0 0 
#Chair01
0 0 1 2 3 11 6 18 24 17 12 9 5 4 4 6 0 0 0 1 4 5 5 5 9 13 18 26 16 5 8 3 1 0 0 0 
