#Desk
0 0 2 3 7 11 18 10 15 15 8 11 10 7 3 2 0 0 0 0 2 4 6 12 10 5 13 14 11 17 13 7 4 1 0 0 
#Chair06
0 0 0 2 3 9 7 17 25 18 13 8 5 3 5 6 1 0 0 0 4 5 4 5 8 14 19 23 16 6 11 3 2 0 0 0 
#Chair05
0 0 0 1 3 8 7 18 24 20 14 8 7 7 4 5 0 0 0 0 4 3 6 6 6 14 16 24 18 6 8 3 1 0 0 0 
#Chair04
0 0 0 2 4 8 5 17 25 17 13 10 7 5 5 4 0 0 0 1 4 5 4 6 8 13 17 22 18 7 9 3 2 1 0 0 
#Chair03
0 0 1 1 3 9 7 19 23 16 12 8 5 5 4 5 0 0 0 0 5 5 6 5 7 13 18 21 19 7 11 4 1 0 0 0 
#Chair02
0 0 1 2 2 10 7 18 22 16 14 7 7 5 5 4 0 0 0 1 3 4 6 6 8 12 18 22 21 9 8 3 1 0 0 0 
#Chair01
0 0 1 2 3 9 7 20 22 16 13 8 4 7 4 4 0 0 0 1 4 5 5 7 8 13 16 24 19 6 8 4 1 0 0 0 
