#Desk
9 25 37 42 42 38 31 19 7 0 
#Chair06
11 36 58 61 43 25 11 5 2 0 
#Chair05
11 36 57 61 44 25 11 5 2 0 
#Chair04
11 36 58 61 42 25 11 5 2 0 
#Chair03
11 36 58 60 42 25 12 6 2 0 
#Chair02
11 35 56 60 44 26 12 5 2 0 
#Chair01
11 34 55 61 44 27 12 6 2 0 
