#Desk
0 0 0 1 9 14 0 2 18 26 18 14 0 0 0 2 8 13 0 0 0 3 8 13 0 3 15 27 13 14 0 0 0 2 8 15 
#Chair06
0 0 0 5 2 7 2 19 56 10 1 0 0 0 0 4 7 11 0 0 0 4 6 8 1 19 55 12 0 0 0 0 0 6 4 6 
#Chair05
0 0 0 4 3 6 1 22 54 13 1 0 0 0 0 6 9 9 0 0 0 4 9 8 1 17 55 9 1 0 0 0 0 4 3 6 
#Chair04
0 0 0 4 4 7 2 20 53 12 0 0 0 0 0 6 8 8 0 0 0 4 6 10 1 20 54 10 0 0 0 0 0 5 2 8 
#Chair03
0 0 0 6 3 6 1 21 52 12 1 0 0 0 0 4 7 10 0 0 0 3 8 10 1 20 55 9 0 0 0 0 0 6 4 6 
#Chair02
0 0 0 5 2 8 1 18 54 11 1 0 0 0 0 6 7 10 0 0 0 5 7 8 1 18 56 14 0 0 0 0 0 3 3 7 
#Chair01
0 0 0 4 3 9 1 19 52 14 1 0 0 0 0 3 9 8 0 0 0 5 8 9 1 21 52 11 1 0 0 0 0 3 3 8 
