#Desk
0 0 0 0 0 0 0 0 0 0 1 4 4 5 5 5 5 8 9 9 10 12 10 9 11 12 12 10 11 10 12 14 13 13 17 14 
#Chair06
0 0 0 0 1 1 2 2 3 6 10 14 15 23 23 15 19 14 8 8 7 7 6 6 4 2 2 4 3 3 3 5 7 8 6 3 
#Chair05
0 0 0 0 0 1 1 2 4 5 12 13 19 21 23 12 17 15 9 7 7 8 5 4 6 5 5 4 3 3 2 4 8 8 6 2 
#Chair04
0 0 0 0 1 1 1 2 3 7 11 15 16 21 25 15 14 14 9 7 8 7 6 4 4 3 4 3 4 3 4 4 8 9 7 2 
#Chair03
0 0 0 0 1 1 2 2 3 6 13 14 17 21 23 17 14 13 8 7 6 7 6 4 5 5 4 3 4 3 4 5 6 8 7 2 
#Chair02
0 0 0 0 1 1 1 1 3 6 10 13 19 19 25 16 14 16 10 7 9 7 5 3 2 3 4 4 3 3 5 3 7 9 8 1 
#Chair01
0 0 0 0 1 0 1 2 3 6 12 13 15 17 22 18 15 14 9 8 8 6 6 4 5 4 4 6 3 3 3 4 8 9 8 2 
