#Table
0 0 0 6 13 9 3 17 28 16 0 0 0 0 0 6 11 7 0 0 0 7 13 8 7 17 32 17 1 0 0 0 0 7 13 8 
#Sofa04
0 0 0 4 16 11 1 12 32 35 4 0 0 0 0 6 20 13 0 0 0 2 12 10 0 5 24 18 0 0 0 0 0 1 13 8 
#Sofa03
0 0 0 2 8 4 2 10 27 37 29 7 0 0 0 1 15 7 0 0 0 2 6 4 1 8 22 25 9 1 0 0 0 1 11 5 
#Sofa02
0 0 0 1 10 6 1 12 29 39 26 6 0 0 0 0 13 5 0 0 0 2 9 4 1 7 20 29 11 0 0 0 0 1 9 5 
#Sofa01
0 0 0 5 13 10 1 24 36 17 0 0 0 0 0 7 18 10 0 0 0 2 12 9 1 15 27 13 0 0 0 0 0 3 11 11 
#Desk
0 0 0 3 5 2 3 8 19 36 27 7 0 0 0 3 6 3 0 0 0 4 5 2 2 12 17 38 24 7 0 0 0 4 4 3 
#Chair08
0 0 0 0 0 9 4 18 42 28 1 2 0 0 0 6 9 7 0 0 0 5 10 6 5 19 41 24 1 2 0 0 0 0 1 7 
#Chair07
0 0 0 0 2 7 2 15 40 33 1 3 0 0 0 5 11 5 0 0 0 6 11 7 4 14 36 30 2 4 0 0 0 0 0 8 
#Chair06
0 0 0 0 2 8 3 20 41 25 2 2 0 0 0 5 11 6 0 0 0 6 10 5 3 20 42 26 1 1 0 0 0 0 1 7 
#Chair05
0 0 0 0 0 6 2 16 43 32 1 5 0 0 0 5 11 5 0 0 0 6 13 5 3 14 38 28 2 4 0 0 0 0 0 6 
#Chair04
0 0 0 0 1 7 4 17 42 28 1 1 0 0 0 5 12 4 0 0 0 7 10 7 3 18 41 24 1 3 0 0 0 0 1 8 
#Chair03
0 0 0 0 2 7 3 20 43 27 1 1 0 0 0 6 10 5 0 0 0 8 10 6 3 17 42 24 0 1 0 0 0 0 1 8 
#Chair02
0 0 0 0 1 6 3 17 41 30 1 4 0 0 0 5 11 5 0 0 0 7 12 6 3 15 38 28 1 4 0 0 0 0 1 7 
#Chair01
0 0 0 0 1 8 3 15 44 32 1 3 0 0 0 6 10 5 0 0 0 5 10 6 3 15 34 31 2 4 0 0 0 0 1 7 
#Cabinet
0 0 0 6 17 11 2 18 35 5 0 0 0 0 0 3 14 8 0 0 0 5 17 10 1 19 38 4 0 0 0 0 0 3 18 10 
