#Table
0 0 0 8 10 9 11 11 11 10 11 11 9 8 6 0 0 0 0 0 0 8 10 10 12 12 14 13 12 10 11 9 8 0 0 0 
#Sofa04
0 0 3 4 11 12 14 15 12 14 14 14 15 16 6 2 0 0 0 0 3 5 9 6 8 8 8 7 8 7 7 8 4 2 0 0 
#Sofa03
0 0 0 0 0 15 25 15 16 14 13 29 14 9 0 0 0 0 0 0 0 0 0 13 18 9 9 8 6 16 8 9 0 0 0 0 
#Sofa02
0 0 0 0 0 18 29 16 16 15 13 24 11 7 0 0 0 0 0 0 0 0 0 16 21 8 8 8 7 16 8 8 0 0 0 0 
#Sofa01
0 0 3 6 11 8 11 15 12 14 14 10 11 13 8 2 0 0 0 0 2 6 9 5 9 9 9 10 11 8 6 9 8 2 0 0 
#Desk
0 0 0 0 4 6 33 8 8 11 8 33 8 4 0 0 0 0 0 0 0 0 4 8 30 10 8 10 8 34 8 4 0 0 0 0 
#Chair08
0 0 1 2 2 3 6 20 23 19 18 9 8 6 5 2 0 0 0 0 2 4 7 7 11 18 18 23 16 5 2 2 3 0 0 0 
#Chair07
0 0 0 2 3 3 13 15 19 17 17 13 9 7 4 0 0 0 0 0 1 5 8 8 13 16 15 17 16 13 3 2 3 0 0 0 
#Chair06
0 0 0 3 2 4 7 17 24 16 20 10 8 7 6 1 0 0 0 0 1 4 5 10 13 16 15 23 20 4 4 1 2 0 0 0 
#Chair05
0 0 0 2 2 2 14 16 18 20 19 12 8 7 5 0 0 0 0 0 1 6 7 10 14 15 13 17 16 14 1 2 2 0 0 0 
#Chair04
0 0 0 1 2 4 5 19 24 18 17 9 9 7 3 2 0 0 0 0 3 5 6 9 10 16 19 20 18 6 4 3 2 0 0 0 
#Chair03
0 0 1 2 2 3 5 19 24 19 19 8 8 7 3 1 0 0 0 0 1 4 7 10 10 17 17 23 19 3 4 4 1 0 0 0 
#Chair02
0 0 0 2 2 2 13 15 19 19 19 12 8 8 4 0 0 0 0 0 1 5 7 11 12 14 16 18 16 12 3 3 1 0 0 0 
#Chair01
0 0 0 3 2 3 11 17 17 20 20 13 9 7 5 0 0 0 0 0 1 7 5 8 13 17 16 16 17 10 2 2 3 0 0 0 
#Cabinet
0 2 3 3 18 7 3 20 5 5 20 6 4 15 3 1 1 0 0 1 4 3 18 6 5 22 5 4 21 5 2 20 3 2 2 0 
