#Table
11 38 48 49 41 29 19 12 4 0 
#Sofa04
6 26 42 51 48 32 23 15 6 0 
#Sofa03
4 23 41 51 53 45 25 8 1 0 
#Sofa02
5 24 41 51 53 45 24 8 1 0 
#Sofa01
9 32 50 56 39 28 19 13 6 0 
#Desk
9 29 42 44 45 48 26 8 1 0 
#Chair08
12 35 50 57 53 28 10 5 2 0 
#Chair07
11 31 45 54 56 32 14 6 2 0 
#Chair06
12 35 50 57 53 28 11 4 2 0 
#Chair05
12 33 46 55 56 31 13 5 2 0 
#Chair04
12 34 48 58 54 29 10 5 2 0 
#Chair03
12 35 49 58 53 27 10 4 2 0 
#Chair02
11 33 47 56 55 30 12 5 2 0 
#Chair01
11 32 46 56 55 31 13 5 2 0 
#Cabinet
12 38 62 40 26 31 16 16 8 1 
