#Table
0 1 1 2 2 3 5 4 3 6 7 7 8 8 9 12 10 11 12 9 11 6 10 9 9 8 10 9 9 5 9 6 6 5 5 1 
#Sofa04
0 0 0 0 0 0 1 2 2 3 3 5 6 6 7 11 11 14 12 12 10 12 11 8 10 8 12 14 10 11 7 11 9 9 4 1 
#Sofa03
0 0 0 0 0 1 1 2 3 2 5 3 6 5 6 8 11 11 11 8 12 11 11 15 17 15 11 12 11 12 10 8 5 3 2 0 
#Sofa02
0 0 0 0 0 1 2 2 3 2 3 5 5 6 7 6 12 11 13 10 11 12 12 12 15 13 14 13 11 12 11 5 5 3 1 0 
#Sofa01
0 0 0 0 0 1 3 2 3 8 8 13 13 11 9 9 9 8 9 10 8 8 6 8 8 9 8 14 10 5 9 9 7 7 6 1 
#Desk
0 0 1 0 1 1 2 2 3 3 3 5 5 6 5 6 5 8 12 12 15 15 15 19 17 17 12 10 9 6 9 7 5 3 1 0 
#Chair08
0 0 0 1 2 4 3 4 5 5 6 11 11 14 15 12 15 14 17 16 10 6 8 5 4 5 5 2 3 3 3 5 7 9 5 2 
#Chair07
0 0 0 0 1 3 4 3 4 3 5 8 8 13 14 14 12 12 16 13 15 12 8 7 6 5 4 5 4 3 4 7 7 9 4 2 
#Chair06
0 0 0 1 1 3 5 5 5 4 8 12 13 15 11 11 16 16 16 15 9 9 7 5 5 5 5 6 2 3 3 4 7 8 6 1 
#Chair05
0 0 0 1 2 2 3 4 4 5 4 6 7 13 16 13 17 13 16 15 14 10 9 6 6 5 4 4 4 4 3 6 8 8 5 2 
#Chair04
0 0 0 1 2 3 5 3 4 5 7 9 14 15 12 14 12 13 17 15 11 9 6 5 6 4 3 5 4 4 2 5 9 8 4 1 
#Chair03
0 0 0 1 2 3 3 5 4 6 6 11 14 16 11 14 12 15 15 16 12 7 8 6 5 4 4 4 4 4 3 3 7 8 5 2 
#Chair02
0 0 0 1 2 2 6 4 4 5 5 6 9 13 18 13 14 11 12 14 15 12 9 7 6 4 4 6 4 3 3 4 8 9 5 2 
#Chair01
0 0 0 1 1 2 4 3 5 5 6 5 8 13 16 12 12 14 16 15 17 12 8 6 5 4 4 4 3 4 4 4 7 9 7 2 
#Cabinet
0 0 0 0 1 2 3 3 3 6 7 13 14 14 13 8 11 10 5 4 5 4 4 4 4 4 9 15 18 16 13 5 4 5 7 3 
