#TV
0 0 0 11 8 12 9 10 12 11 10 10 8 7 10 0 0 0 0 0 0 9 9 8 11 13 14 13 13 10 9 8 10 0 0 0 
#Notebook06
0 0 0 6 8 10 16 13 11 9 9 7 8 12 7 0 0 0 0 0 0 8 6 7 12 13 13 14 15 13 12 10 5 0 0 0 
#Notebook05
0 0 0 7 9 13 13 13 9 10 10 6 10 13 8 0 0 0 0 0 0 6 9 8 8 15 15 13 14 11 13 8 5 0 0 0 
#Notebook04
0 0 0 7 10 12 13 11 12 8 9 8 12 13 8 0 0 0 0 0 0 5 8 8 9 14 14 14 13 12 11 8 6 0 0 0 
#Notebook03
0 0 0 6 12 12 14 12 10 9 8 7 11 11 6 0 0 0 0 0 0 8 8 7 11 12 13 15 13 12 11 10 5 0 0 0 
#Notebook02
0 0 0 4 10 9 17 12 10 8 9 6 9 12 9 0 0 0 0 0 0 6 8 6 10 14 16 15 14 13 11 10 6 0 0 0 
#Notebook01
0 0 0 7 9 11 13 13 14 11 8 9 9 11 7 0 0 0 0 0 0 8 8 8 9 11 15 13 14 11 12 11 5 0 0 0 
#Lamp02
0 0 1 36 35 10 4 2 0 0 1 0 0 2 2 29 0 0 0 0 25 1 1 0 0 0 0 1 2 6 13 30 36 2 0 0 
#Lamp01
0 0 2 37 35 10 4 3 1 1 0 0 1 2 1 29 0 0 0 0 29 1 2 0 0 0 1 1 1 4 12 33 30 2 0 0 
#Desk
0 0 4 9 6 5 7 8 11 11 12 13 10 10 9 3 0 0 0 0 2 8 11 12 10 13 14 12 8 8 8 5 7 3 0 0 
#CordedPhone
0 0 1 3 6 8 8 11 12 13 12 11 9 8 7 0 0 0 0 0 0 11 7 9 11 13 16 15 13 19 14 6 1 0 0 0 
#Chair06
0 0 4 5 6 9 9 9 31 27 14 3 2 1 2 0 0 0 0 0 0 2 3 3 3 12 27 30 6 9 12 6 3 3 1 0 
#Chair05
0 0 3 5 7 10 7 7 31 33 10 3 3 3 2 0 0 0 0 0 0 3 2 2 3 14 27 28 7 6 11 6 4 3 0 0 
#Chair04
0 0 2 4 7 10 8 7 32 27 13 4 2 3 2 0 0 0 0 0 0 2 3 2 4 13 28 30 6 7 13 4 4 2 0 0 
#Chair03
0 0 2 5 6 13 8 8 31 29 10 3 3 3 2 0 0 0 0 0 0 2 3 2 4 11 29 30 8 8 11 6 4 2 1 0 
#Chair02
0 0 3 5 6 12 8 7 31 29 12 3 3 2 2 0 0 0 0 0 0 2 2 2 4 11 27 30 7 7 11 6 5 3 0 0 
#Chair01
0 1 2 5 5 11 7 5 32 26 14 3 2 1 2 0 0 0 0 0 0 3 2 2 5 12 31 32 7 6 11 6 3 3 0 0 
#Camera
0 0 0 0 0 2 3 4 5 6 8 9 7 5 2 0 0 0 0 0 0 0 0 8 35 25 30 43 16 10 8 8 5 5 0 0 
#Cabinet02
0 0 14 9 10 10 10 12 15 11 10 11 9 7 8 12 0 0 0 0 11 4 4 5 7 8 9 9 7 7 6 4 4 9 0 0 
#Cabinet01
0 0 11 8 8 8 9 11 12 10 14 14 10 7 7 12 0 0 0 0 10 4 6 6 7 7 8 9 9 8 7 5 3 12 0 0 
#Bottle06
2 4 3 2 5 7 9 16 16 12 9 6 6 7 6 4 8 0 0 7 2 3 5 9 9 9 15 16 16 7 6 4 2 2 2 3 
#Bottle05
2 4 2 2 5 7 8 16 16 13 10 8 7 5 4 3 7 0 0 6 3 4 6 8 7 9 15 16 15 7 8 5 3 2 2 3 
#Bottle04
3 3 2 2 5 5 9 15 20 16 9 7 6 4 4 3 7 0 0 6 3 7 6 6 6 8 12 18 17 7 6 7 4 1 3 1 
#Bottle03
2 3 2 2 6 7 6 14 19 15 9 8 7 6 5 4 6 0 0 7 3 5 6 6 7 9 13 17 16 7 6 5 2 2 3 2 
#Bottle02
1 3 2 4 4 7 8 14 16 15 9 9 8 6 4 4 7 0 0 8 3 5 6 6 8 10 13 17 13 6 7 7 2 3 3 3 
#Bottle01
2 2 2 3 6 7 9 14 18 16 10 8 7 5 4 3 7 0 0 6 3 5 6 6 7 7 16 16 13 9 7 7 2 3 2 2 
