#TV
13 34 45 49 45 30 19 12 5 0 
#Notebook06
12 33 44 47 43 35 22 12 3 0 
#Notebook05
12 32 43 46 44 35 23 13 3 0 
#Notebook04
12 32 41 46 44 36 23 13 4 0 
#Notebook03
12 33 42 46 43 35 23 13 3 0 
#Notebook02
12 33 43 46 43 35 22 13 4 0 
#Notebook01
12 32 43 47 44 35 22 13 4 0 
#Lamp02
10 32 40 37 24 13 11 17 40 27 
#Lamp01
9 31 40 35 25 14 11 17 40 28 
#Desk
13 35 46 51 39 26 19 13 8 1 
#CordedPhone
9 33 53 58 43 27 17 9 2 0 
#Chair06
13 33 49 54 53 30 12 7 2 0 
#Chair05
13 32 47 53 53 31 12 7 2 0 
#Chair04
13 33 49 54 51 30 12 7 2 0 
#Chair03
13 34 50 54 52 28 11 6 2 0 
#Chair02
13 34 50 54 52 29 12 7 2 0 
#Chair01
13 33 48 53 52 31 13 7 2 0 
#Camera
8 34 59 62 43 27 14 4 0 0 
#Cabinet02
8 27 48 53 36 27 20 15 11 4 
#Cabinet01
8 27 49 53 36 27 21 15 11 4 
#Bottle06
12 36 65 43 34 25 16 10 6 4 
#Bottle05
12 36 65 44 34 25 16 10 5 4 
#Bottle04
12 37 67 43 34 25 15 9 5 3 
#Bottle03
12 37 66 44 34 25 15 9 5 3 
#Bottle02
12 36 64 44 34 25 16 10 6 4 
#Bottle01
12 37 67 44 34 24 15 9 5 3 
