#TV
0 0 0 6 15 9 3 16 28 17 0 0 0 0 0 4 12 9 0 0 0 4 13 7 3 17 32 21 1 0 0 0 0 5 14 9 
#Notebook06
0 0 0 5 11 8 4 14 20 22 6 0 0 0 0 3 16 8 0 0 0 3 13 5 4 18 28 27 3 0 0 0 0 7 14 6 
#Notebook05
0 0 0 8 14 7 4 13 18 22 5 0 0 0 0 4 18 8 0 0 0 3 12 7 4 15 25 27 4 0 0 0 0 6 13 6 
#Notebook04
0 0 0 5 16 8 4 11 18 24 5 0 0 0 0 6 18 9 0 0 0 4 11 5 5 16 24 28 3 0 0 0 0 7 12 7 
#Notebook03
0 0 0 6 15 8 5 12 18 20 7 0 0 0 0 6 15 8 0 0 0 3 13 6 5 16 25 27 5 0 0 0 0 6 13 6 
#Notebook02
0 0 0 4 12 7 3 11 19 23 6 0 0 0 0 3 19 8 0 0 0 3 10 7 7 19 27 24 5 0 0 0 0 7 12 8 
#Notebook01
0 0 0 6 13 8 5 12 21 23 6 0 0 0 0 2 17 7 0 0 0 2 15 7 6 17 22 24 4 0 0 0 0 7 13 8 
#Lamp02
0 0 0 8 9 66 0 3 4 0 0 0 0 0 0 0 4 30 0 0 0 0 2 26 2 3 6 1 0 0 0 0 0 10 8 63 
#Lamp01
0 0 0 8 9 67 2 3 4 0 0 0 0 0 0 1 3 29 0 0 0 1 2 29 2 2 4 1 0 0 0 0 0 9 9 60 
#Desk
0 0 0 4 8 13 0 18 29 16 0 0 0 0 0 4 14 14 0 0 0 5 17 14 0 14 35 17 0 0 0 0 0 6 8 11 
#CordedPhone
0 0 0 6 7 6 2 26 32 7 0 0 0 0 0 9 11 5 0 0 0 2 13 12 5 17 27 31 7 0 0 0 0 6 7 7 
#Chair06
0 0 0 4 14 8 7 25 33 17 5 6 0 0 0 0 1 5 0 0 0 0 1 7 7 26 27 17 5 4 0 0 0 7 11 8 
#Chair05
0 0 0 5 13 8 6 27 34 15 4 6 0 0 0 0 1 8 0 0 0 0 1 7 6 24 29 16 6 4 0 0 0 7 11 8 
#Chair04
0 0 0 5 13 6 8 26 32 14 5 6 0 0 0 0 0 6 0 0 0 0 2 7 6 25 33 14 5 5 0 0 0 8 10 6 
#Chair03
0 0 0 7 12 7 7 27 32 16 3 4 0 0 0 0 1 8 0 0 0 0 1 7 7 25 33 14 6 5 0 0 0 5 13 6 
#Chair02
0 0 0 7 12 8 7 26 33 15 4 6 0 0 0 0 1 6 0 0 0 0 1 6 7 25 33 12 6 5 0 0 0 7 12 8 
#Chair01
0 0 0 7 11 7 8 22 32 16 5 6 0 0 0 0 1 4 0 0 0 0 1 7 8 26 32 16 5 6 0 0 0 6 12 7 
#Camera
0 0 0 1 0 0 0 14 16 6 0 0 0 0 0 4 6 5 0 0 0 1 6 1 7 30 40 36 32 15 0 0 0 6 12 8 
#Cabinet02
0 0 0 6 15 23 0 13 41 16 0 0 0 0 0 5 11 20 0 0 0 3 6 15 0 15 25 9 0 0 0 0 0 3 7 13 
#Cabinet01
0 0 0 5 11 19 0 13 41 17 0 0 0 0 0 6 11 20 0 0 0 4 9 13 0 16 24 10 0 0 0 0 0 4 8 15 
#Bottle06
0 0 0 8 5 11 0 38 25 6 0 0 0 0 0 5 10 17 0 0 0 7 8 12 0 41 25 7 0 0 0 0 0 7 3 10 
#Bottle05
0 0 0 8 5 12 0 39 27 6 0 0 0 0 0 6 7 14 0 0 0 6 9 13 0 40 24 7 0 0 0 0 0 10 4 12 
#Bottle04
0 0 0 6 4 11 0 46 25 7 0 0 0 0 0 5 7 14 0 0 0 5 8 15 0 38 26 5 0 0 0 0 0 9 6 9 
#Bottle03
0 0 0 9 5 9 0 43 25 6 0 0 0 0 0 7 8 15 0 0 0 5 9 14 0 40 25 5 0 0 0 0 0 8 5 10 
#Bottle02
0 0 0 8 5 11 0 40 25 7 0 0 0 0 0 7 9 14 0 0 0 5 8 15 0 38 24 6 0 0 0 0 0 9 6 11 
#Bottle01
0 0 0 9 4 9 0 44 26 7 0 0 0 0 0 5 7 14 0 0 0 6 8 14 0 40 24 6 0 0 0 0 0 8 6 10 
