#TV
0 1 0 1 2 2 3 5 6 4 5 7 7 8 8 9 12 14 12 9 9 10 10 8 8 7 9 8 9 13 13 9 5 4 2 0 
#Notebook06
0 0 1 2 2 2 3 4 6 6 6 5 8 6 8 7 7 9 8 10 12 15 12 9 10 10 8 11 12 12 9 7 5 2 3 1 
#Notebook05
0 0 1 2 2 2 3 4 5 6 4 4 7 6 6 5 8 8 10 9 11 16 14 10 12 10 12 10 12 11 11 6 5 4 1 1 
#Notebook04
0 0 1 2 1 2 4 4 3 4 4 5 5 6 5 7 9 7 8 11 13 13 14 13 10 11 11 9 10 14 9 7 4 3 2 2 
#Notebook03
0 0 2 2 2 2 4 4 3 4 6 4 7 5 5 7 8 8 9 9 11 14 12 12 11 15 10 11 12 10 8 7 5 4 2 2 
#Notebook02
0 0 1 2 2 3 3 3 5 5 5 7 5 8 7 8 8 8 9 9 12 14 10 11 11 9 12 10 10 12 7 7 5 4 3 2 
#Notebook01
0 0 1 2 2 4 4 4 4 5 6 5 6 7 8 7 7 6 8 9 11 14 13 10 11 12 11 13 12 11 8 6 7 4 2 2 
#Lamp02
0 0 0 0 0 0 0 1 1 1 1 1 0 1 1 2 1 2 1 1 3 2 3 9 7 8 6 0 0 1 1 15 23 46 54 45 
#Lamp01
0 1 0 1 0 0 0 0 0 1 1 1 0 1 1 1 1 2 2 1 2 2 3 9 8 7 6 1 0 0 0 14 22 44 57 48 
#Desk
0 0 0 0 0 0 2 5 5 7 6 6 7 10 13 13 9 10 10 8 7 10 9 8 8 8 9 7 6 9 9 8 11 11 8 3 
#CordedPhone
0 0 1 1 1 3 4 5 6 7 9 9 11 8 9 9 11 9 9 12 11 10 8 10 7 7 9 8 7 6 6 9 4 5 4 1 
#Chair06
0 1 1 2 4 5 5 7 7 9 9 10 10 12 11 10 8 7 6 5 5 5 7 17 14 8 5 3 3 3 5 8 7 7 7 4 
#Chair05
0 1 0 2 3 4 6 7 8 9 9 10 14 11 12 10 7 7 6 5 5 4 7 15 15 7 6 4 3 3 5 7 9 9 7 3 
#Chair04
0 0 1 2 4 5 5 6 7 9 9 11 12 15 10 9 8 9 7 5 5 4 6 15 13 9 4 4 3 3 4 7 8 7 9 2 
#Chair03
0 1 1 2 4 5 6 6 9 7 10 12 12 11 10 10 12 8 8 4 4 3 9 14 12 8 5 3 4 3 5 8 7 8 6 3 
#Chair02
0 0 1 3 4 4 5 7 9 10 9 10 11 12 12 11 9 8 4 5 4 4 7 15 14 7 5 3 4 4 6 6 8 7 7 3 
#Chair01
0 1 1 2 5 4 5 5 7 8 9 12 13 11 12 9 8 8 5 6 5 4 7 16 15 6 5 4 2 2 4 7 7 7 9 4 
#Camera
0 0 0 1 2 3 3 5 6 9 11 8 9 9 8 10 10 8 8 8 11 10 9 9 8 7 9 11 10 10 9 6 4 5 2 0 
#Cabinet02
0 0 0 0 0 0 0 0 3 4 8 11 15 15 8 10 6 10 9 8 6 6 7 7 6 7 7 6 6 6 6 8 19 24 12 2 
#Cabinet01
0 0 0 0 0 0 0 0 4 4 7 12 12 13 8 9 10 10 8 8 7 8 8 7 6 6 7 6 7 6 5 6 19 22 12 2 
#Bottle06
0 0 0 0 0 0 0 0 15 33 16 14 10 11 10 6 6 5 6 7 5 6 6 11 6 4 3 5 3 4 6 4 5 4 4 27 
#Bottle05
0 0 0 0 0 0 0 0 15 35 15 12 11 12 9 6 6 5 6 7 6 7 7 8 8 5 3 3 2 3 6 4 5 5 4 26 
#Bottle04
0 0 0 0 0 0 0 0 16 35 19 13 11 13 9 4 7 6 5 8 6 6 5 7 6 4 3 3 4 3 8 4 6 4 4 23 
#Bottle03
0 0 0 0 0 0 0 0 19 34 15 14 10 9 11 8 5 4 6 5 6 7 8 8 8 4 4 3 4 3 6 4 5 5 4 23 
#Bottle02
0 0 0 0 0 0 0 0 15 34 13 14 8 10 10 6 6 6 5 9 6 8 7 8 6 4 5 4 3 3 8 3 6 4 5 24 
#Bottle01
0 0 0 0 0 0 0 0 18 35 17 13 9 10 10 7 7 6 6 7 8 6 7 8 7 4 3 3 3 3 6 4 5 4 4 23 
