#TV
14 35 44 48 43 30 20 13 4 0 
#Speaker02
4 16 29 38 48 50 40 21 5 0 
#Speaker01
4 15 28 37 48 50 40 24 5 0 
#Desk
22 54 50 40 30 22 18 11 4 0 
#Chair09
9 22 38 53 53 37 21 13 5 0 
#Chair08
9 23 39 53 53 36 21 13 5 0 
#Chair07
9 23 39 53 53 36 21 13 5 0 
#Chair06
9 23 39 54 54 36 19 12 4 0 
#Chair05
9 22 39 52 54 38 22 12 4 0 
#Chair04
9 22 39 52 54 38 22 13 4 0 
#Chair03
9 22 40 54 52 36 20 13 4 0 
#Chair02
9 23 40 54 52 36 20 12 4 0 
#Chair014
9 22 39 52 53 38 21 13 5 0 
#Chair013
9 22 39 52 53 37 21 13 5 0 
#Chair012
9 23 39 53 53 37 20 12 4 0 
#Chair011
9 23 39 53 53 36 20 13 4 0 
#Chair010
9 23 39 53 53 37 21 12 4 0 
#Chair01
9 23 40 54 54 36 20 12 4 0 
#Carpet
16 40 50 49 38 26 18 11 3 0 
