#Desk
0 0 0 2 6 9 2 10 19 12 12 31 0 0 0 2 5 9 0 0 0 2 6 9 3 13 17 11 12 35 0 0 0 2 5 9 
#Chair08
0 0 0 1 1 11 4 16 41 23 1 0 0 0 0 5 8 7 0 0 0 6 10 5 4 17 41 24 2 0 0 0 0 0 1 15 
#Chair07
0 0 0 0 1 14 4 17 42 24 1 0 0 0 0 7 10 8 0 0 0 6 7 7 5 14 37 24 1 0 0 0 0 0 1 14 
#Chair06
0 0 0 0 3 12 5 17 42 21 0 0 0 0 0 7 9 7 0 0 0 8 8 8 5 18 38 21 2 0 0 0 0 1 1 12 
#Chair05
0 0 0 1 2 12 4 17 41 21 0 0 0 0 0 7 8 7 0 0 0 9 9 9 5 17 38 22 2 0 0 0 0 0 1 12 
#Chair04
0 0 0 0 3 14 6 15 38 21 0 0 0 0 0 6 9 8 0 0 0 5 10 7 5 14 43 25 2 0 0 0 0 0 2 12 
#Chair03
0 0 0 1 2 13 5 16 39 20 1 0 0 0 0 7 9 8 0 0 0 6 8 6 5 18 39 24 2 0 0 0 0 1 2 14 
#Chair02
0 0 0 1 2 13 5 16 39 19 1 0 0 0 0 8 9 8 0 0 0 6 8 6 5 19 40 25 2 0 0 0 0 1 2 13 
#Chair01
0 0 0 0 1 14 4 19 41 19 1 0 0 0 0 7 8 7 0 0 0 6 9 7 5 16 39 26 1 0 0 0 0 0 1 12 
#CellPhone
0 0 0 6 12 12 3 14 25 18 2 0 0 0 0 5 9 14 0 0 0 4 12 16 3 15 28 19 1 0 0 0 0 4 10 14 
#Book03
0 0 0 6 12 5 6 14 30 23 3 0 0 0 0 8 11 6 0 0 0 5 12 4 6 17 29 23 2 0 0 0 0 5 12 4 
#Book02
0 0 0 8 12 6 6 14 30 24 2 0 0 0 0 6 12 5 0 0 0 4 12 4 6 17 30 23 2 0 0 0 0 6 13 4 
#Book01
0 0 0 8 11 6 6 14 31 23 3 0 0 0 0 6 12 5 0 0 0 5 12 4 6 17 29 23 2 0 0 0 0 6 12 4 
