#Desk
0 0 1 3 4 7 11 15 19 18 12 12 6 5 3 1 0 0 0 0 1 4 4 6 10 16 19 22 14 11 6 4 3 2 0 0 
#Chair08
0 0 0 3 5 5 1 5 22 25 16 15 6 5 4 3 2 0 0 0 3 4 6 7 14 20 27 20 6 2 4 5 5 0 0 0 
#Chair07
0 0 0 4 6 6 2 4 20 23 21 16 7 7 6 4 0 0 0 0 4 5 4 7 16 17 23 19 6 1 6 5 4 0 0 0 
#Chair06
0 0 0 3 5 7 2 5 19 27 18 15 7 7 4 3 1 0 0 0 4 5 6 9 13 15 27 23 5 1 5 5 3 0 0 0 
#Chair05
0 0 0 3 5 7 2 5 18 26 18 14 7 7 4 3 1 0 0 0 4 5 6 9 13 15 26 23 5 1 5 5 3 0 0 0 
#Chair04
0 0 0 4 5 8 2 4 19 26 14 15 8 5 5 3 1 0 0 0 3 5 7 5 16 18 28 20 6 1 6 4 3 0 0 0 
#Chair03
0 0 1 3 6 4 1 4 20 24 16 15 8 6 5 3 1 0 0 1 2 6 6 6 15 15 30 22 4 1 6 5 4 1 0 0 
#Chair02
0 0 1 3 6 4 1 4 20 24 16 15 8 6 5 3 1 0 0 1 2 5 6 6 16 17 30 22 4 1 6 5 4 1 0 0 
#Chair01
0 0 1 4 6 4 2 4 20 27 18 12 8 5 6 3 0 0 0 1 3 4 6 7 16 21 23 20 5 2 4 4 4 1 0 0 
#CellPhone
0 0 6 6 7 11 11 9 12 11 9 9 8 6 6 7 0 0 0 0 8 7 9 7 9 11 10 12 11 13 9 6 7 6 0 0 
#Book03
0 0 0 5 9 9 13 13 13 14 12 10 12 9 4 0 0 0 0 0 0 3 8 10 13 13 15 14 11 12 10 8 4 0 0 0 
#Book02
0 0 0 4 9 12 10 12 14 13 13 12 9 9 5 0 0 0 0 0 0 3 8 9 12 11 14 14 13 13 10 9 4 0 0 0 
#Book01
0 0 0 4 9 12 10 12 14 13 13 13 9 9 5 0 0 0 0 0 0 3 9 10 12 11 14 14 13 13 10 8 3 0 0 0 
