#Screen
0 0 1 1 2 2 4 3 4 4 6 6 5 10 6 7 7 9 10 13 14 14 14 14 12 11 11 10 7 7 6 4 4 4 4 2 
#Rack
0 0 0 3 5 7 7 10 8 8 9 8 8 6 4 4 5 6 4 5 5 8 4 6 7 7 6 6 8 10 6 9 6 8 26 10 
#Picture04
0 1 1 2 2 3 3 3 4 6 4 6 7 8 8 8 9 10 8 10 10 14 14 12 10 11 13 14 11 7 5 5 4 4 2 0 
#Picture03
0 0 2 2 4 3 5 5 5 5 8 8 9 10 11 11 12 10 9 8 8 8 9 8 8 8 8 8 8 8 8 9 6 6 2 1 
#Picture02
0 1 1 2 2 2 3 4 4 6 5 5 7 8 7 9 8 9 9 10 13 15 13 12 11 9 12 10 9 9 8 5 6 3 1 1 
#Picture01
0 1 1 1 1 2 3 3 4 6 6 6 7 8 8 8 9 9 11 9 12 14 10 9 10 11 14 11 12 10 6 5 5 2 2 0 
#Desk
0 0 3 5 5 7 8 8 8 13 10 7 7 8 6 8 6 9 5 7 9 9 9 11 11 10 9 6 6 5 3 4 5 4 4 2 
#Chair09
0 1 1 1 2 3 2 3 2 5 4 5 7 7 7 9 7 8 10 9 8 10 8 13 13 14 9 9 6 9 8 8 8 9 8 6 
#Chair08
0 1 1 1 2 3 3 3 2 5 4 5 7 7 7 9 7 8 9 9 8 10 8 12 13 13 9 8 6 9 8 9 8 9 8 7 
#Chair07
0 1 0 1 2 3 2 3 4 4 4 4 4 5 8 8 7 7 12 7 12 12 11 12 13 14 11 8 6 8 9 8 9 8 8 7 
#Chair06
0 1 1 1 2 3 2 3 4 4 4 4 4 5 8 8 7 7 11 7 12 12 11 12 13 14 12 7 6 7 9 8 9 7 8 7 
#Chair05
0 1 1 1 2 3 2 2 4 4 4 4 4 5 8 8 6 7 12 7 12 12 11 12 13 14 11 7 6 8 9 8 9 8 8 7 
#Chair04
0 1 0 1 2 3 2 3 4 4 4 4 4 5 8 8 6 7 12 7 11 11 11 12 13 14 11 8 6 8 9 8 9 7 9 7 
#Chair03
0 1 1 2 2 3 2 3 5 5 4 5 5 6 6 8 7 9 11 8 8 11 9 10 12 12 9 7 8 8 9 8 9 9 9 8 
#Chair02
0 1 1 2 2 3 2 3 5 5 4 5 5 6 5 8 7 8 11 9 8 12 9 11 13 12 9 7 8 9 8 7 9 9 9 8 
#Chair014
0 1 1 1 3 3 3 3 4 5 5 7 4 5 8 8 7 7 10 7 8 11 8 12 10 14 10 9 6 9 8 8 7 9 10 7 
#Chair013
0 1 1 1 3 3 3 3 4 5 5 7 4 5 8 8 7 7 10 6 8 11 8 12 9 14 10 9 6 9 8 8 7 9 10 7 
#Chair012
0 1 1 1 2 4 2 4 4 4 4 5 8 6 7 6 6 9 9 9 8 9 10 13 15 12 9 9 7 8 8 7 9 7 8 8 
#Chair011
0 1 1 0 2 4 3 4 4 4 4 5 8 5 7 6 6 9 9 9 9 9 9 13 14 12 9 9 7 8 7 7 10 8 8 7 
#Chair010
0 1 1 0 2 4 2 4 4 4 4 5 8 5 7 6 6 9 9 8 9 9 10 13 14 12 9 9 7 8 7 7 10 7 8 7 
#Chair01
0 1 1 2 2 2 4 4 4 3 4 6 7 5 5 8 7 7 9 10 9 10 10 11 13 14 9 9 6 7 8 7 8 9 11 7 
#CellingLight04
0 0 0 1 4 6 7 5 7 6 5 7 8 9 12 12 10 12 11 8 8 7 5 5 4 3 5 6 5 7 5 6 7 6 7 26 
#CellingLight03
0 0 0 0 3 5 8 8 5 6 7 6 5 11 18 11 10 8 12 9 8 4 4 4 4 4 5 5 4 6 5 4 7 8 6 27 
#CellingLight02
0 0 0 1 4 6 5 8 7 6 7 5 8 10 15 12 8 10 13 10 8 4 4 5 6 6 4 4 4 6 5 6 8 6 7 21 
#CellingLight01
0 0 0 0 3 4 6 6 4 5 8 6 9 12 15 10 11 10 13 11 7 2 2 4 4 5 5 7 7 6 6 8 7 6 9 22 
#Bonsai
0 0 0 1 1 2 3 4 7 7 10 9 11 10 14 9 10 14 12 9 11 8 8 11 8 9 8 7 7 6 5 5 6 3 3 0 
