#Screen
14 32 43 46 45 38 23 9 2 0 
#Rack
24 48 42 36 29 23 19 15 12 4 
#Picture04
13 33 44 47 44 36 22 10 2 0 
#Picture03
16 39 49 49 37 26 18 12 5 0 
#Picture02
13 33 45 47 44 34 21 11 2 0 
#Picture01
13 33 44 47 44 35 21 12 2 0 
#Desk
22 55 51 40 30 22 17 10 4 0 
#Chair09
9 22 39 53 53 38 21 13 4 0 
#Chair08
9 22 39 53 53 37 21 12 4 0 
#Chair07
9 22 38 51 53 39 22 12 4 0 
#Chair06
9 22 39 52 54 39 22 12 4 0 
#Chair05
9 22 39 52 54 39 22 12 4 0 
#Chair04
9 22 38 51 54 39 22 13 4 0 
#Chair03
9 22 39 53 55 36 20 12 5 0 
#Chair02
9 22 39 53 54 36 21 13 5 0 
#Chair014
9 23 40 53 54 36 20 12 4 0 
#Chair013
9 22 39 53 54 36 20 12 4 0 
#Chair012
9 23 40 54 53 36 20 12 4 0 
#Chair011
9 23 39 54 53 36 20 13 5 0 
#Chair010
9 23 40 54 53 36 20 13 4 0 
#Chair01
9 22 39 53 53 37 21 13 5 0 
#CellingLight04
7 32 47 48 44 34 20 11 5 2 
#CellingLight03
8 33 47 48 44 34 20 10 5 2 
#CellingLight02
8 34 49 49 44 33 19 10 4 2 
#CellingLight01
7 32 46 48 44 34 21 11 6 2 
#Bonsai
8 33 55 58 47 31 14 5 1 0 
