#Screen
0 0 1 2 2 2 4 3 5 5 6 5 7 7 7 9 9 11 12 14 17 14 12 13 10 9 9 9 9 10 4 5 4 2 1 0 
#Projector
0 0 0 0 0 0 1 0 0 2 1 1 3 5 2 4 4 5 4 4 5 4 9 11 14 16 15 15 25 24 19 13 11 12 10 1 
#Pencil07
2 9 7 7 7 6 7 6 8 6 7 6 8 7 6 6 7 7 7 8 8 7 9 7 7 7 9 7 7 6 6 6 4 5 4 3 
#Pencil06
2 9 7 8 7 6 7 6 7 7 7 6 8 7 7 7 7 7 7 8 8 7 9 7 8 7 9 7 6 6 6 6 4 6 4 3 
#Pencil05
2 9 8 8 7 6 7 6 8 6 7 6 7 7 6 6 8 7 7 8 7 7 9 7 7 7 9 7 7 6 6 6 4 6 3 3 
#Pencil04
3 9 8 9 8 8 7 7 7 7 6 7 7 8 6 6 8 7 7 7 7 7 5 6 6 9 11 6 6 7 5 6 3 7 2 4 
#Pencil03
3 9 9 9 8 8 7 7 7 7 6 8 7 8 6 6 8 7 7 6 7 6 5 7 6 9 11 6 6 7 5 6 3 6 2 4 
#Pencil02
2 9 8 8 8 8 6 7 7 7 6 8 7 8 6 6 9 7 7 7 7 7 6 6 7 9 10 6 6 7 5 6 4 7 2 4 
#Pencil01
3 9 8 8 8 8 7 7 7 7 6 8 7 8 6 6 8 7 7 6 7 7 5 6 6 9 11 6 7 7 5 6 4 7 2 4 
#Paper07
0 1 1 3 2 4 2 4 6 6 6 8 7 7 8 10 8 13 10 9 16 12 12 13 11 13 10 11 4 8 4 4 3 1 0 0 
#Paper06
0 1 1 2 2 4 3 4 6 7 6 8 7 7 8 11 8 12 10 9 15 11 12 13 11 13 11 10 4 8 4 4 4 2 0 0 
#Paper05
0 1 1 3 2 4 2 4 7 6 6 8 7 7 9 10 8 13 10 9 16 11 12 13 11 13 10 11 4 8 4 4 4 1 0 0 
#Paper04
0 1 1 2 2 4 2 4 6 6 6 8 7 8 9 10 9 12 10 9 15 11 11 13 11 14 11 10 4 8 5 3 4 1 0 0 
#Paper03
0 1 1 2 2 2 3 6 5 5 7 7 7 10 10 8 11 10 12 10 13 11 14 15 14 12 12 8 5 6 4 2 2 2 1 0 
#Paper02
0 1 1 2 2 2 3 6 5 5 7 7 7 10 9 9 11 9 12 11 12 11 14 15 15 12 12 8 6 6 4 2 2 2 1 0 
#Paper01
0 1 1 2 2 3 3 5 5 5 7 7 7 9 10 9 11 10 12 10 13 12 14 15 14 12 12 8 5 6 4 2 2 2 1 0 
#Desk
0 1 1 2 2 3 3 4 5 5 7 7 8 9 11 12 12 12 9 10 10 9 9 9 9 8 6 8 8 7 5 10 8 6 2 1 
#Chair07
0 0 0 0 0 2 2 3 3 4 5 5 6 8 9 10 9 9 10 10 7 8 8 6 5 6 4 8 14 19 20 19 10 5 3 0 
#Chair06
0 0 0 0 0 2 2 3 3 4 5 5 7 8 9 9 9 9 11 10 7 8 7 6 5 6 5 8 15 19 20 19 11 5 3 0 
#Chair05
0 0 0 0 0 2 2 3 3 4 5 5 7 8 9 10 9 9 10 9 7 8 7 6 5 6 5 8 15 18 19 19 11 5 2 1 
#Chair04
0 0 0 1 1 1 3 3 3 4 5 5 6 8 11 8 8 9 9 9 8 7 6 5 6 6 4 11 14 18 19 19 10 5 4 1 
#Chair03
0 0 0 1 1 1 3 3 3 5 5 4 6 8 11 9 8 9 9 9 8 7 6 6 6 6 4 11 15 18 19 19 10 5 4 1 
#Chair02
0 0 0 1 1 1 3 3 3 5 5 5 6 8 11 9 8 9 9 10 8 7 6 6 6 6 4 11 15 18 19 19 10 5 4 1 
#Chair01
0 0 0 1 1 1 3 2 3 4 5 5 6 8 11 8 8 10 9 9 8 7 6 5 6 6 4 11 15 18 19 19 10 5 4 1 
#Board
0 0 2 6 6 9 8 9 11 11 15 13 13 14 10 10 7 8 8 7 5 6 6 4 6 6 5 5 6 5 4 3 3 4 3 1 
#AirVent02
0 0 1 1 1 1 2 2 2 3 3 4 5 4 5 5 11 12 15 13 14 9 11 9 9 17 15 15 13 14 8 6 5 3 2 1 
#AirVent01
0 0 1 1 1 1 2 2 2 3 3 4 5 5 5 5 11 11 15 12 14 9 11 9 9 17 15 16 13 14 7 6 5 2 2 0 
