#TV02
0 0 0 7 7 9 13 11 21 16 13 13 10 7 7 0 0 0 0 0 0 8 7 9 10 11 12 10 9 9 8 7 9 0 0 0 
#TV01
0 0 0 7 9 6 11 15 23 17 14 12 8 7 8 0 0 0 0 0 0 8 8 8 10 11 8 12 12 7 7 8 8 0 0 0 
#Screen
0 0 0 8 9 10 11 12 13 12 14 12 10 10 10 0 0 0 0 0 0 7 8 9 8 14 11 9 10 12 8 9 8 0 0 0 
#Projector
0 0 0 1 9 29 22 22 12 9 8 11 6 5 0 0 0 0 0 0 0 0 3 8 10 7 7 7 16 17 23 13 0 0 0 0 
#Desk
0 1 3 4 4 6 24 13 12 8 7 21 7 4 3 3 1 0 0 1 2 6 4 5 20 13 11 10 9 19 6 4 5 3 1 0 
#Chair09
0 0 2 1 4 11 5 18 26 18 21 5 3 3 2 3 2 0 0 1 3 3 3 5 5 22 20 23 14 4 11 3 2 1 0 0 
#Chair08
0 0 1 1 3 14 5 16 28 18 21 4 4 4 2 2 1 0 0 0 3 3 3 4 5 20 19 24 14 4 13 4 1 0 0 0 
#Chair07
0 0 1 1 3 10 4 14 27 18 22 5 4 3 2 4 1 0 0 2 3 1 3 4 5 22 21 25 14 4 11 5 1 0 0 0 
#Chair06
0 0 1 1 3 12 5 12 26 19 21 5 4 5 3 2 1 0 0 1 3 3 3 6 5 18 26 25 14 3 11 3 1 0 0 0 
#Chair05
0 0 0 1 3 11 4 14 26 16 22 3 4 4 3 3 1 0 0 1 3 2 4 3 4 21 22 29 15 4 12 3 1 0 0 0 
#Chair04
0 0 1 0 2 12 4 14 27 17 22 3 3 3 3 5 1 0 0 1 3 3 6 4 5 23 20 23 14 3 13 3 1 1 0 0 
#Chair03
0 0 1 2 3 13 4 14 25 18 22 5 4 3 3 2 1 0 0 1 3 2 4 4 5 24 21 25 12 3 10 3 1 0 0 0 
#Chair02
0 0 1 0 4 12 4 15 24 17 23 5 4 3 3 2 1 0 0 1 2 3 3 5 4 21 22 24 16 4 14 3 1 0 0 0 
#Chair01
0 0 2 1 2 11 4 15 23 20 23 6 3 4 3 2 1 0 0 1 3 2 4 5 6 22 18 26 17 4 11 3 1 0 0 0 
#Camera
0 0 0 0 0 0 2 4 4 5 7 9 8 6 3 0 0 0 0 0 0 0 0 7 34 29 29 44 18 8 10 9 5 4 0 0 
#Bookshelf
0 0 0 0 17 11 11 10 12 10 11 10 7 19 0 0 0 0 0 0 0 0 20 11 10 12 12 12 11 9 10 21 0 0 0 0 
