#TV02
12 31 42 47 44 37 22 12 4 0 
#TV01
13 31 41 46 45 38 22 12 4 0 
#Screen
13 31 42 46 43 36 22 13 5 0 
#Projector
5 21 39 47 47 45 33 12 1 0 
#Desk
19 50 58 40 34 23 17 8 3 0 
#Chair09
12 38 58 66 41 22 9 5 1 0 
#Chair08
12 38 59 66 41 21 9 4 1 0 
#Chair07
12 39 58 67 41 20 9 4 1 0 
#Chair06
13 38 58 67 41 20 9 4 1 0 
#Chair05
12 40 60 65 40 20 8 4 1 0 
#Chair04
12 38 57 67 41 21 9 5 1 0 
#Chair03
12 38 58 67 41 21 9 4 1 0 
#Chair02
12 37 58 67 42 21 9 5 1 0 
#Chair01
12 39 59 67 40 20 9 4 1 0 
#Camera
7 30 55 65 47 28 15 4 0 0 
#Bookshelf
6 21 36 51 42 36 34 20 5 0 
