#TV02
0 1 1 1 2 2 2 4 5 3 4 5 5 6 7 8 11 11 12 9 12 10 12 11 12 13 10 12 8 9 11 6 5 4 3 3 
#TV01
0 0 1 1 1 2 2 3 4 3 6 6 5 6 7 8 13 9 13 9 13 12 11 13 10 11 11 9 9 10 12 6 7 4 4 2 
#Screen
0 0 1 1 2 3 3 2 5 4 5 7 4 6 7 6 9 10 9 12 13 11 9 9 12 9 10 10 9 13 10 6 7 6 4 2 
#Projector
0 0 0 0 0 0 0 0 2 3 3 3 4 3 2 2 4 3 4 6 11 17 16 17 19 20 18 21 21 12 12 7 4 3 2 0 
#Desk
0 1 2 2 4 4 4 8 6 9 10 10 10 8 10 7 10 17 16 13 10 9 11 6 5 3 4 4 5 6 4 6 4 4 4 2 
#Chair09
0 0 0 0 1 1 3 3 5 8 15 20 25 23 15 11 12 9 9 8 6 5 6 6 4 3 4 4 3 3 2 2 6 6 6 5 
#Chair08
0 0 0 0 1 1 2 4 7 8 18 17 20 23 13 11 14 9 10 8 6 6 6 7 7 5 3 4 3 3 2 2 4 4 7 3 
#Chair07
0 0 1 0 0 2 2 4 7 7 14 17 23 22 19 11 14 9 12 8 6 5 6 5 6 4 4 2 2 3 1 2 5 5 8 3 
#Chair06
0 0 0 0 1 2 2 4 7 7 15 18 22 24 16 13 12 9 7 9 7 4 6 6 6 6 4 3 4 2 2 2 5 5 6 3 
#Chair05
0 0 1 1 1 3 2 4 6 8 15 18 21 23 18 11 14 9 8 8 6 4 4 6 4 4 4 3 3 3 3 2 5 7 6 3 
#Chair04
0 0 0 1 1 1 3 3 6 8 14 16 24 23 16 12 13 10 10 8 4 6 6 7 4 3 3 5 3 3 3 4 3 7 5 3 
#Chair03
0 0 1 0 1 1 2 5 6 7 14 18 22 21 16 12 14 12 7 9 7 5 7 6 4 4 2 2 3 2 2 3 6 6 5 4 
#Chair02
0 0 0 1 0 1 2 3 6 9 12 21 21 23 17 11 13 9 9 9 6 7 5 6 7 4 3 3 2 4 3 3 4 5 6 4 
#Chair01
0 0 0 0 1 1 2 4 5 9 16 17 25 22 15 12 14 10 11 8 7 6 6 6 4 4 3 5 2 3 1 2 5 5 5 4 
#Camera
0 0 0 0 1 2 2 3 5 5 6 12 11 8 11 9 11 9 8 11 8 10 10 8 9 9 9 7 10 10 9 9 8 6 3 1 
#Bookshelf
0 0 0 0 0 2 1 1 2 4 3 6 4 4 5 3 4 5 5 6 5 10 16 16 14 15 19 18 15 12 11 10 7 9 4 0 
