#TV02
0 0 0 5 10 8 3 12 30 28 15 0 0 0 0 4 12 7 0 0 0 4 12 9 5 12 20 20 3 0 0 0 0 4 11 9 
#TV01
0 0 0 3 11 9 4 13 29 35 13 0 0 0 0 3 11 8 0 0 0 4 11 9 4 12 20 21 3 0 0 0 0 4 12 8 
#Screen
0 0 0 4 15 9 5 14 22 27 6 0 0 0 0 5 13 12 0 0 0 4 12 7 3 14 24 19 3 0 0 0 0 4 13 7 
#Projector
0 0 0 12 21 6 1 9 14 27 28 6 0 0 0 2 6 3 0 0 0 3 5 2 0 4 7 19 29 6 0 0 0 8 21 6 
#Desk
0 0 0 6 7 6 6 25 33 22 0 0 0 0 0 7 6 6 0 0 0 6 8 6 8 24 32 19 0 0 0 0 0 6 6 7 
#Chair09
0 0 0 6 5 6 2 28 50 10 1 0 0 0 0 3 4 7 0 0 0 3 5 7 2 28 46 12 1 0 0 0 0 6 5 6 
#Chair08
0 0 0 9 6 4 2 30 49 11 1 0 0 0 0 2 6 6 0 0 0 2 5 7 3 28 43 12 1 0 0 0 0 7 6 5 
#Chair07
0 0 0 5 5 6 2 25 50 11 1 1 0 0 0 3 5 7 0 0 0 3 5 6 2 29 50 12 0 0 0 0 0 7 6 4 
#Chair06
0 0 0 7 5 4 1 27 49 9 1 1 0 0 0 2 7 7 0 0 0 4 6 7 2 28 49 10 1 0 0 0 0 7 5 4 
#Chair05
0 0 0 7 5 4 4 27 46 8 1 0 0 0 0 3 5 8 0 0 0 2 5 8 3 29 52 10 0 1 0 0 0 7 5 4 
#Chair04
0 0 0 8 4 4 2 27 47 11 1 0 0 0 0 2 5 9 0 0 0 3 6 9 2 26 53 8 1 0 0 0 0 9 4 4 
#Chair03
0 0 0 9 6 6 2 27 48 11 1 0 0 0 0 2 4 8 0 0 0 3 4 8 2 28 51 10 0 1 0 0 0 7 3 5 
#Chair02
0 0 0 7 6 4 2 28 45 13 1 0 0 0 0 2 5 7 0 0 0 3 6 7 2 27 51 9 0 1 0 0 0 8 6 5 
#Chair01
0 0 0 7 4 4 2 29 49 11 1 0 0 0 0 2 5 6 0 0 0 3 6 7 2 27 50 13 0 1 0 0 0 7 5 4 
#Camera
0 0 0 0 0 0 0 8 19 7 0 0 0 0 0 4 8 5 0 0 0 1 4 1 3 27 42 38 32 22 0 0 0 7 12 8 
#Bookshelf
0 0 0 3 14 10 1 9 14 23 16 0 0 0 0 2 14 10 0 0 0 3 16 12 3 10 14 24 17 0 0 0 0 3 16 12 
