#VacuumFlask03
7 23 36 52 41 29 23 22 18 1 
#VacuumFlask02
7 22 36 52 41 29 23 21 18 1 
#VacuumFlask01
7 23 36 52 41 29 23 22 18 1 
#Table
12 29 40 41 37 33 32 21 5 0 
#Desk
13 30 40 43 32 25 21 19 25 3 
#Cup09
7 24 43 58 60 32 19 8 1 0 
#Cup08
7 23 42 58 60 33 20 8 2 0 
#Cup07
7 24 43 58 60 32 19 7 1 0 
#Cup06
6 22 41 57 59 34 21 9 2 0 
#Cup05
7 24 43 57 59 33 19 8 2 0 
#Cup04
6 23 42 57 59 34 20 8 2 0 
#Cup03
7 23 42 57 59 33 20 8 2 0 
#Cup02
7 23 42 57 60 33 19 8 1 0 
#Cup012
6 23 42 57 60 33 20 8 2 0 
#Cup011
7 23 41 57 61 33 20 8 1 0 
#Cup010
7 24 43 58 60 32 18 7 1 0 
#Cup01
7 24 42 57 60 33 19 7 1 0 
#Chair08
10 33 51 56 39 28 20 11 3 0 
#Chair07
11 33 52 58 40 27 19 10 3 0 
#Chair06
10 33 51 56 40 28 20 11 3 0 
#Chair05
10 33 51 56 40 28 19 11 3 0 
#Chair04
10 33 52 55 39 28 19 11 3 0 
#Chair03
11 33 51 56 40 28 19 10 3 0 
#Chair02
10 33 51 56 39 28 19 11 3 0 
#Chair01
10 33 50 56 39 28 20 12 4 0 
