#VacuumFlask03
0 0 0 3 12 15 0 9 25 8 0 0 0 0 0 3 14 10 0 0 0 1 17 26 0 0 23 33 1 0 0 0 0 0 23 24 
#VacuumFlask02
0 0 0 3 13 14 0 9 27 8 0 0 0 0 0 3 14 10 0 0 0 0 17 25 0 0 24 32 1 0 0 0 0 0 22 23 
#VacuumFlask01
0 0 0 3 11 14 0 9 26 9 0 0 0 0 0 3 13 10 0 0 0 0 19 26 0 0 24 32 1 0 0 0 0 0 24 24 
#Table
0 0 0 1 29 18 0 0 9 74 25 0 0 0 0 1 28 17 0 0 0 1 16 7 0 0 0 0 0 0 0 0 0 0 16 6 
#Desk
0 0 0 1 11 29 0 4 24 20 1 0 0 0 0 2 13 28 0 0 0 1 8 29 0 5 22 13 0 0 0 0 0 1 9 24 
#Cup09
0 0 0 5 6 6 2 8 35 31 18 4 0 0 0 2 2 4 0 0 0 1 2 4 2 12 34 28 19 4 0 0 0 3 5 6 
#Cup08
0 0 0 2 5 4 3 10 30 33 19 6 0 0 0 0 2 4 0 0 0 0 2 6 3 11 31 34 20 3 0 0 0 3 6 6 
#Cup07
0 0 0 5 6 6 2 9 35 31 18 4 0 0 0 2 2 4 0 0 0 1 3 4 2 12 35 27 19 4 0 0 0 3 5 6 
#Cup06
0 0 0 2 6 4 2 10 31 30 20 6 0 0 0 1 2 4 0 0 0 0 3 6 1 9 34 32 19 5 0 0 0 4 5 7 
#Cup05
0 0 0 5 4 4 2 11 33 33 19 3 0 0 0 0 2 4 0 0 0 1 3 6 2 11 32 30 17 5 0 0 0 4 5 7 
#Cup04
0 0 0 4 7 4 2 10 31 31 16 5 0 0 0 1 3 6 0 0 0 1 2 5 1 11 33 32 19 4 0 0 0 3 6 6 
#Cup03
0 0 0 4 5 6 2 11 31 29 18 7 0 0 0 1 2 4 0 0 0 1 2 4 2 11 35 35 18 7 0 0 0 3 5 6 
#Cup02
0 0 0 4 6 6 2 12 33 30 18 5 0 0 0 1 3 4 0 0 0 1 2 5 2 9 34 31 19 5 0 0 0 2 5 5 
#Cup012
0 0 0 4 6 6 1 11 31 32 19 5 0 0 0 0 2 3 0 0 0 1 2 5 2 10 33 27 20 5 0 0 0 3 5 7 
#Cup011
0 0 0 3 5 7 2 9 31 31 16 5 0 0 0 1 3 4 0 0 0 1 4 4 2 9 36 32 21 4 0 0 0 4 5 5 
#Cup010
0 0 0 4 3 4 3 11 37 30 18 6 0 0 0 1 2 3 0 0 0 1 3 5 2 11 31 30 18 5 0 0 0 5 6 4 
#Cup01
0 0 0 4 6 4 3 10 37 31 19 4 0 0 0 1 2 5 0 0 0 2 3 4 1 10 32 30 18 5 0 0 0 3 6 4 
#Chair08
0 0 0 6 9 11 3 19 36 19 3 0 0 0 0 5 12 2 0 0 0 3 13 4 2 18 33 17 4 0 0 0 0 5 9 12 
#Chair07
0 0 0 5 9 11 2 23 35 16 5 0 0 0 0 3 12 3 0 0 0 3 11 3 2 17 38 18 4 0 0 0 0 5 10 10 
#Chair06
0 0 0 6 8 12 2 19 33 16 4 0 0 0 0 3 11 4 0 0 0 3 12 4 2 20 34 19 4 0 0 0 0 6 9 11 
#Chair05
0 0 0 7 7 10 2 20 33 18 4 0 0 0 0 5 14 2 0 0 0 4 13 4 3 20 33 17 4 0 0 0 0 6 11 10 
#Chair04
0 0 0 6 8 12 2 21 31 16 4 0 0 0 0 4 11 4 0 0 0 3 13 4 2 21 34 18 5 0 0 0 0 6 9 11 
#Chair03
0 0 0 6 11 9 1 23 34 15 7 0 0 0 0 3 11 4 0 0 0 5 11 4 2 19 33 19 4 0 0 0 0 6 9 9 
#Chair02
0 0 0 6 8 11 2 20 34 17 5 0 0 0 0 5 10 3 0 0 0 4 13 4 3 19 32 16 4 0 0 0 0 6 10 11 
#Chair01
0 0 0 6 10 10 3 20 36 15 4 0 0 0 0 3 12 5 0 0 0 4 13 3 2 19 31 18 4 0 0 0 0 5 10 13 
