#VacuumFlask03
0 0 3 12 9 5 6 7 8 8 8 5 6 11 3 6 0 0 0 0 12 12 11 9 11 9 10 9 9 9 7 21 14 4 0 0 
#VacuumFlask02
0 0 3 12 11 5 6 6 8 9 8 6 6 12 3 6 0 0 0 0 11 11 11 9 9 9 10 9 9 8 8 20 14 3 0 0 
#VacuumFlask01
0 0 3 11 8 5 6 6 8 9 8 6 6 10 3 6 0 0 0 0 11 13 12 8 9 9 10 10 9 8 8 22 13 4 0 0 
#Table
0 0 0 1 24 23 17 18 19 17 17 18 22 22 2 0 0 0 0 0 0 0 11 14 0 0 0 0 0 0 11 12 0 0 0 0 
#Desk
0 0 0 28 6 7 8 7 7 8 9 9 9 6 27 1 0 0 0 0 0 29 4 6 4 7 8 7 7 6 4 5 24 1 0 0 
#Cup09
0 0 1 2 3 11 20 15 17 15 15 17 3 2 1 1 0 0 0 0 0 1 1 3 16 17 16 17 14 20 7 3 2 0 0 0 
#Cup08
0 0 0 1 4 5 17 18 19 17 13 18 3 2 2 0 0 0 0 0 1 2 3 2 17 17 19 16 14 19 7 5 2 1 0 0 
#Cup07
0 0 1 2 3 10 20 15 17 15 15 18 3 1 1 1 0 0 0 0 0 1 1 3 16 17 16 17 14 20 7 3 2 0 0 0 
#Cup06
0 0 0 2 4 6 18 16 16 16 12 19 3 2 1 0 0 0 0 0 1 3 3 2 19 14 15 16 17 19 8 3 2 1 0 0 
#Cup05
0 0 1 1 3 7 16 18 17 14 17 19 2 2 1 1 0 0 0 0 1 2 2 4 16 17 15 15 16 18 9 3 2 1 0 0 
#Cup04
0 0 0 2 4 8 16 16 15 16 17 16 3 3 2 0 0 0 0 0 1 1 2 3 19 15 18 16 14 19 7 4 3 1 0 0 
#Cup03
0 0 1 2 4 7 16 15 15 17 15 18 3 1 1 1 0 0 0 0 0 1 1 3 19 17 17 15 19 20 7 3 2 0 0 0 
#Cup02
0 0 1 2 4 8 19 14 18 13 17 19 3 2 2 0 0 0 0 0 0 2 2 3 19 17 14 16 16 17 6 3 2 1 0 0 
#Cup012
0 0 1 3 4 9 19 17 16 15 17 16 2 1 0 1 0 0 0 0 1 1 2 3 19 16 17 14 13 18 7 3 3 1 0 0 
#Cup011
0 0 1 2 5 6 17 14 16 14 17 16 3 2 0 1 0 0 0 0 0 1 2 4 20 17 16 15 18 17 8 2 3 1 0 0 
#Cup010
0 0 0 2 2 7 19 17 14 18 18 19 2 2 0 1 0 0 0 0 1 2 3 3 15 14 16 17 17 17 9 5 1 0 0 0 
#Cup01
0 0 0 3 5 6 19 17 17 13 20 17 3 2 2 1 0 0 0 0 0 2 3 4 16 16 15 15 16 18 8 2 2 0 0 0 
#Chair08
0 0 7 5 6 7 9 7 9 10 23 21 12 4 3 0 0 0 0 0 2 2 5 10 19 17 10 8 9 9 6 6 6 8 0 0 
#Chair07
0 0 7 5 6 6 8 9 10 12 21 20 11 5 1 1 0 0 0 0 1 2 5 9 21 23 10 8 9 8 6 7 5 6 0 0 
#Chair06
0 0 7 5 6 7 7 7 9 11 20 21 10 4 3 1 0 0 0 0 1 4 4 11 22 22 11 8 9 7 8 6 5 6 0 0 
#Chair05
0 0 6 5 5 8 9 7 9 11 21 19 14 4 2 0 0 0 0 0 2 2 4 12 19 21 9 9 9 8 8 7 5 6 0 0 
#Chair04
0 0 7 6 6 7 8 7 9 10 20 20 11 3 3 1 0 0 0 0 0 4 4 12 22 22 11 8 10 6 8 6 6 6 0 0 
#Chair03
0 0 5 6 7 7 7 10 8 12 20 22 9 5 3 1 0 0 0 0 1 4 4 12 21 19 11 9 7 9 7 6 4 6 0 0 
#Chair02
0 0 7 6 5 7 8 8 10 11 23 19 12 3 3 1 0 0 0 0 1 3 4 13 18 21 11 9 9 7 8 6 6 7 0 0 
#Chair01
0 0 6 5 7 7 7 9 10 10 21 20 9 5 4 1 0 0 0 0 0 2 5 11 20 21 9 10 7 6 6 7 7 8 0 0 
