#Desk
0 0 0 0 0 0 0 2 6 7 13 14 9 8 10 10 9 9 11 11 16 18 15 10 7 7 6 9 7 8 6 3 1 2 5 2 
#Chair09
0 0 0 0 0 1 3 2 4 7 14 16 18 22 21 15 11 7 7 6 7 6 5 5 4 5 6 4 4 4 3 5 8 10 8 3 
#Chair08
0 0 0 0 1 1 1 2 3 7 13 17 19 21 24 16 10 7 6 7 7 5 5 6 5 4 4 4 4 4 5 5 6 10 9 2 
#Chair07
0 0 0 0 1 1 3 3 4 6 12 15 21 23 21 15 10 6 7 6 6 6 5 6 5 5 6 3 5 4 4 4 9 9 7 3 
#Chair06
0 0 0 0 0 1 2 2 3 7 13 14 19 26 22 13 11 9 5 6 6 8 7 3 5 4 5 3 4 3 4 6 6 11 9 3 
#Chair05
0 0 0 0 1 2 3 2 4 8 11 17 17 24 23 13 11 7 7 7 6 5 4 6 4 4 4 4 3 5 3 6 7 9 9 2 
#Chair04
0 0 0 0 2 1 1 2 5 6 12 14 18 24 23 14 11 8 7 6 8 6 6 4 3 4 6 5 3 4 4 4 7 9 8 2 
#Chair03
0 0 0 0 1 2 2 2 4 9 11 14 15 23 24 16 9 8 7 8 8 7 6 3 4 6 3 4 3 4 4 6 7 9 9 3 
#Chair020
0 0 0 0 1 1 2 3 3 6 14 16 19 24 24 14 10 8 6 6 6 6 4 4 5 5 4 3 3 4 2 6 8 10 7 2 
#Chair02
0 0 0 0 1 2 2 2 5 8 12 16 18 21 23 14 11 8 6 8 7 6 4 5 5 5 5 3 3 4 3 5 7 11 7 2 
#Chair019
0 0 0 0 1 1 2 2 4 5 10 15 21 24 21 14 11 8 5 7 8 7 6 6 5 3 4 4 4 3 4 6 6 10 8 2 
#Chair018
0 0 0 0 1 1 2 2 3 7 14 16 17 22 24 15 10 7 5 6 8 6 6 6 5 4 5 6 4 5 4 4 5 9 7 3 
#Chair017
0 0 0 0 1 1 1 2 3 6 15 15 18 24 23 14 11 8 6 5 6 6 6 6 4 4 3 4 3 5 4 6 8 9 8 2 
#Chair016
0 0 0 0 0 1 1 2 4 7 14 16 16 23 22 14 11 9 7 5 8 7 5 7 5 5 3 3 4 4 4 6 8 9 7 3 
#Chair015
0 0 0 0 1 1 1 3 5 7 15 14 21 20 22 14 10 9 5 6 6 7 6 5 6 4 4 5 3 5 4 5 6 9 7 2 
#Chair014
0 0 0 0 1 0 2 2 4 6 15 19 21 22 24 13 11 6 7 7 7 6 6 4 5 5 4 2 3 4 6 5 6 8 7 3 
#Chair013
0 0 0 0 0 1 1 1 4 6 14 16 19 22 25 13 10 7 6 6 8 7 6 7 4 4 5 5 3 3 4 5 8 9 8 2 
#Chair012
0 0 0 0 1 1 1 2 3 7 11 13 19 25 26 15 12 6 5 7 6 7 7 5 5 4 5 3 4 5 5 5 7 8 8 3 
#Chair011
0 0 0 0 1 1 2 3 4 7 12 14 18 21 24 14 11 6 6 5 6 6 5 6 5 5 5 4 5 5 4 6 7 11 9 2 
#Chair010
0 0 0 0 1 1 1 3 4 8 13 14 17 22 24 14 10 7 6 7 6 8 5 4 5 6 6 4 4 5 3 6 7 7 8 3 
#Chair01
0 0 0 0 1 1 2 2 4 7 12 16 19 24 24 14 10 7 5 6 8 8 6 4 4 4 4 6 5 3 3 4 7 10 7 3 
