#Desk
0 0 0 6 5 16 10 11 15 14 11 10 15 6 7 0 0 0 0 0 0 4 4 17 9 10 11 13 12 11 17 3 6 0 0 0 
#Chair09
0 0 0 2 3 9 7 19 21 14 9 9 6 5 6 6 0 0 0 1 5 4 5 8 10 10 15 20 19 9 12 3 2 1 0 0 
#Chair08
0 0 1 1 4 8 9 18 23 13 12 8 7 6 5 6 0 0 0 0 4 5 6 6 8 9 16 19 21 7 11 4 1 0 0 0 
#Chair07
0 0 0 2 3 9 9 22 20 14 10 9 6 8 4 6 0 0 0 0 5 4 5 7 8 11 16 20 18 8 11 4 2 1 0 0 
#Chair06
0 0 1 2 3 8 9 20 22 14 9 10 8 4 5 8 1 0 0 0 4 4 6 7 9 9 14 21 18 8 12 2 2 0 0 0 
#Chair05
0 0 2 3 2 9 8 19 22 13 11 8 6 5 5 5 0 0 0 0 5 6 5 6 11 10 15 23 17 8 10 5 3 0 0 0 
#Chair04
0 0 0 2 4 10 9 22 23 16 7 10 6 6 5 5 0 0 0 1 3 5 7 7 8 10 13 20 21 8 7 5 2 1 0 0 
#Chair03
0 0 0 2 3 9 8 20 20 14 7 10 6 6 5 5 1 0 0 1 4 6 5 7 9 9 14 21 22 7 10 4 2 1 0 0 
#Chair020
0 0 0 2 3 9 9 23 21 14 10 8 7 5 5 4 0 0 0 0 5 5 5 6 9 9 15 23 20 8 10 3 2 1 0 0 
#Chair02
0 0 1 3 3 10 9 18 22 14 9 9 7 6 5 4 0 0 0 0 5 5 5 6 10 10 15 19 24 7 10 3 2 1 0 0 
#Chair019
0 0 1 2 3 10 6 23 20 15 9 11 7 6 5 5 0 0 0 0 6 5 5 8 8 8 16 22 17 7 10 3 2 1 0 0 
#Chair018
0 0 0 2 2 9 8 23 22 13 10 8 6 7 6 5 1 0 0 0 5 6 6 8 9 9 15 19 19 8 11 4 1 1 0 0 
#Chair017
0 0 1 1 4 9 7 18 24 15 9 9 7 4 5 4 0 0 0 1 4 6 6 8 10 8 13 22 22 8 10 4 2 0 0 0 
#Chair016
0 0 1 2 3 9 8 17 19 14 10 11 9 6 6 6 0 0 0 0 5 7 6 7 9 9 14 20 22 6 7 3 2 0 0 0 
#Chair015
0 0 1 1 3 10 6 19 21 13 11 10 6 7 6 5 0 0 0 1 5 4 6 7 9 10 14 23 21 7 10 3 2 0 0 0 
#Chair014
0 0 1 2 2 8 8 20 21 17 10 9 8 8 5 5 0 0 0 0 4 4 5 5 10 9 15 20 20 7 9 3 2 1 0 0 
#Chair013
0 0 1 2 4 10 7 19 20 15 7 10 9 6 6 5 1 0 0 0 5 4 7 6 9 9 16 21 22 6 11 3 3 0 0 0 
#Chair012
0 0 0 2 3 10 7 19 21 14 10 10 7 5 7 6 1 0 0 1 3 6 5 8 8 11 15 22 17 8 7 5 1 1 0 0 
#Chair011
0 0 1 3 3 9 5 19 23 13 10 10 7 9 5 5 0 0 0 0 6 7 7 6 8 11 12 22 18 9 9 3 2 1 0 0 
#Chair010
0 0 1 1 3 8 11 20 20 16 11 6 8 7 5 6 1 0 0 0 4 7 6 5 10 9 15 21 18 9 8 3 2 0 0 0 
#Chair01
0 0 1 1 3 9 9 19 21 14 11 11 7 5 3 4 1 0 0 1 7 5 7 6 9 10 13 20 17 10 12 5 2 0 0 0 
