#Desk
13 34 47 52 46 31 19 8 2 0 
#Chair09
13 38 57 56 39 26 13 7 3 0 
#Chair08
12 38 57 57 39 26 13 7 3 0 
#Chair07
12 38 57 57 39 26 13 7 3 0 
#Chair06
12 37 56 57 39 26 13 7 3 0 
#Chair05
12 38 57 56 39 26 13 7 3 0 
#Chair04
12 38 57 57 39 26 13 6 3 0 
#Chair03
12 38 56 56 39 26 14 7 3 0 
#Chair020
12 38 58 57 39 25 13 6 2 0 
#Chair02
12 38 57 57 39 26 13 6 3 0 
#Chair019
12 37 56 58 39 26 13 7 3 0 
#Chair018
12 38 57 56 39 26 13 7 2 0 
#Chair017
12 38 57 57 39 26 13 6 3 0 
#Chair016
13 38 56 57 39 26 13 7 3 0 
#Chair015
13 38 57 57 39 26 13 6 3 0 
#Chair014
13 40 58 57 38 25 12 6 2 0 
#Chair013
12 37 56 58 39 26 13 7 3 0 
#Chair012
13 37 56 57 39 26 13 7 3 0 
#Chair011
12 37 56 56 39 27 14 7 3 0 
#Chair010
13 38 56 57 39 26 13 6 2 0 
#Chair01
13 39 58 56 38 25 13 7 3 0 
