#TV
13 36 47 49 43 30 19 11 4 0 
#Picture
11 35 49 49 39 27 20 14 6 0 
#Desk
12 43 64 49 37 25 15 6 1 0 
#CordedPhone
9 30 47 58 48 33 19 7 0 0 
#Chair06
9 29 47 62 51 30 14 7 2 0 
#Chair05
9 28 46 61 51 31 14 8 3 0 
#Chair04
9 29 47 62 50 29 14 8 3 0 
#Chair03
9 28 46 60 51 31 15 8 4 0 
#Chair02
9 28 46 61 51 30 14 8 3 0 
#Chair01
9 27 46 60 51 31 15 8 3 0 
#Camera
9 35 52 58 51 31 12 3 0 0 
