#Desk
0 0 1 3 4 7 13 12 16 17 12 9 7 8 4 1 0 0 0 0 1 2 6 8 10 10 19 22 12 13 9 7 5 1 0 0 
#Chair05
0 0 0 1 1 3 3 17 21 25 22 9 8 8 5 2 1 0 0 1 2 4 7 10 18 29 23 15 4 2 1 0 0 0 0 0 
#Chair03
0 0 1 1 2 2 3 16 21 22 21 10 9 9 5 3 1 0 0 1 2 5 9 10 17 27 17 14 5 3 3 0 0 0 0 0 
#Chair02
0 0 1 2 4 1 3 14 22 24 22 12 10 9 4 4 1 0 0 1 2 4 6 6 16 27 22 17 5 2 2 0 0 0 0 0 
#Chair01
0 0 0 1 2 1 3 16 23 24 19 13 8 8 5 4 1 0 0 1 2 4 7 11 18 27 21 14 5 2 1 0 0 0 0 0 
