#Desk
0 0 0 7 13 8 13 26 24 2 0 0 0 0 0 8 11 10 0 0 0 9 12 8 13 24 24 3 0 0 0 0 0 9 13 9 
#Chair09
0 0 0 0 1 3 4 24 39 17 1 3 0 0 0 9 10 9 0 0 0 8 11 8 6 26 43 15 0 2 0 0 0 0 1 4 
#Chair08
0 0 0 0 0 4 3 19 39 14 1 2 0 0 0 8 11 11 0 0 0 7 12 10 5 25 48 17 1 2 0 0 0 0 1 3 
#Chair07
0 0 0 0 1 3 3 22 43 14 1 2 0 0 0 8 9 13 0 0 0 8 12 10 3 25 44 15 1 3 0 0 0 0 1 3 
#Chair06
0 0 0 0 1 4 4 22 39 19 1 3 0 0 0 8 11 8 0 0 0 7 13 10 3 23 48 13 0 2 0 0 0 0 1 5 
#Chair05
0 0 0 0 0 3 3 24 39 14 1 2 0 0 0 10 12 11 0 0 0 9 11 11 4 25 42 18 0 2 0 0 0 0 1 4 
#Chair04
0 0 0 0 1 4 3 23 42 17 0 2 0 0 0 8 9 9 0 0 0 8 14 11 5 24 40 16 0 3 0 0 0 0 0 5 
#Chair03
0 0 0 0 1 5 3 23 44 16 1 3 0 0 0 9 12 9 0 0 0 6 12 8 4 22 45 18 1 3 0 0 0 0 1 3 
#Chair02
0 0 0 0 1 4 3 25 41 14 1 3 0 0 0 7 9 11 0 0 0 8 12 10 6 24 44 16 1 2 0 0 0 0 1 3 
#Chair012
0 0 0 0 0 4 4 19 46 16 1 2 0 0 0 10 10 13 0 0 0 9 9 8 5 23 45 16 0 2 0 0 0 0 1 4 
#Chair011
0 0 0 0 1 4 4 22 41 13 2 2 0 0 0 8 11 11 0 0 0 7 12 8 6 24 44 17 1 2 0 0 0 0 1 4 
#Chair010
0 0 0 0 1 3 3 19 45 14 1 2 0 0 0 8 12 10 0 0 0 6 13 10 4 26 43 17 1 2 0 0 0 0 0 4 
#Chair01
0 0 0 0 1 6 4 22 42 15 0 2 0 0 0 8 12 11 0 0 0 6 12 9 5 22 45 14 1 2 0 0 0 0 1 3 
#Cabinet
0 0 0 5 8 9 1 24 33 5 0 0 0 0 0 6 10 15 0 0 0 6 10 13 1 23 35 9 0 0 0 0 0 7 10 14 
