#Desk
0 0 3 8 8 8 9 9 13 14 9 9 7 8 6 5 1 0 0 1 3 7 8 9 9 10 13 12 9 10 8 10 8 4 1 0 
#Chair09
0 0 0 0 2 1 2 3 18 32 21 11 12 7 5 5 0 0 0 0 4 6 7 10 12 16 39 20 2 3 1 2 2 0 0 0 
#Chair08
0 0 0 2 1 1 2 3 17 29 16 12 11 6 5 8 0 0 0 0 5 6 6 11 13 18 40 22 2 2 1 1 2 0 0 0 
#Chair07
0 0 0 1 1 2 2 3 19 29 18 14 11 6 5 8 0 0 0 0 5 6 7 11 10 18 36 21 4 3 2 2 1 0 0 0 
#Chair06
0 0 0 1 1 2 3 3 18 32 19 14 9 7 4 5 0 0 0 0 6 6 7 11 12 18 36 19 3 2 3 1 2 0 0 0 
#Chair05
0 0 0 1 0 2 2 3 18 30 18 11 13 8 5 6 0 0 0 0 6 6 7 12 12 19 35 20 3 2 1 2 2 0 0 0 
#Chair04
0 0 0 1 1 2 2 3 22 30 18 12 12 4 5 5 0 0 0 0 6 6 8 11 12 19 31 22 3 2 2 1 2 0 0 0 
#Chair03
0 0 0 1 1 2 2 3 21 31 19 13 11 7 5 5 0 0 0 0 4 6 7 9 11 19 32 23 4 3 2 1 1 0 0 0 
#Chair02
0 0 0 1 1 2 2 4 20 31 21 11 9 5 5 7 0 0 0 0 6 6 6 11 12 22 36 18 2 2 2 1 1 0 0 0 
#Chair012
0 0 0 1 2 1 2 3 17 34 19 12 12 6 7 7 0 0 0 0 4 5 5 11 11 19 34 22 3 2 2 1 1 0 0 0 
#Chair011
0 0 0 2 2 1 2 3 18 33 18 11 10 8 6 5 0 0 0 0 5 3 8 11 13 18 37 21 4 1 2 1 2 0 0 0 
#Chair010
0 0 0 2 1 1 3 3 19 29 19 13 11 7 5 7 0 0 0 0 5 8 8 9 10 19 35 23 3 2 1 1 2 0 0 0 
#Chair01
0 0 0 3 2 2 3 3 16 31 21 11 11 8 5 7 0 0 0 0 5 6 7 9 12 18 33 21 3 2 1 1 2 0 0 0 
#Cabinet
0 2 5 4 5 6 10 13 8 10 14 6 7 7 5 7 4 0 0 2 7 5 6 8 8 15 9 10 16 9 9 7 6 6 1 0 
