#Desk
22 52 50 38 32 22 17 12 6 0 
#Chair09
18 46 60 59 39 17 8 3 1 0 
#Chair08
17 44 57 59 42 18 8 3 2 0 
#Chair07
17 43 57 59 43 19 9 4 2 0 
#Chair06
17 43 57 58 41 19 9 4 2 0 
#Chair05
17 44 59 60 42 17 8 3 1 0 
#Chair04
17 43 57 59 42 19 9 4 2 0 
#Chair03
17 42 56 60 42 20 9 4 2 0 
#Chair02
17 45 58 58 41 19 9 3 2 0 
#Chair012
17 44 58 60 42 18 8 3 1 0 
#Chair011
17 44 57 59 41 19 9 4 2 0 
#Chair010
17 44 57 61 43 18 8 3 2 0 
#Chair01
16 43 56 58 41 20 10 4 2 0 
#Cabinet
11 40 55 46 31 25 20 12 8 3 
