#Screen
0 0 0 3 17 10 4 11 35 41 2 0 0 0 0 5 19 9 0 0 0 5 10 3 3 12 21 16 2 0 0 0 0 4 9 3 
#Projector
0 0 0 0 12 16 0 4 11 18 25 3 0 0 0 1 14 12 0 0 0 1 15 16 0 3 11 20 31 2 0 0 0 1 12 16 
#Lamp02
0 0 0 16 40 38 2 1 1 0 0 0 0 0 0 0 0 23 0 0 0 1 0 21 1 2 2 0 0 0 0 0 0 20 38 41 
#Lamp01
0 0 0 16 38 40 2 2 1 0 0 0 0 0 0 0 0 22 0 0 0 1 0 23 1 2 1 0 0 0 0 0 0 20 39 39 
#Desk
0 0 0 6 9 15 6 21 25 5 0 0 0 0 0 8 9 19 0 0 0 8 11 18 4 20 24 3 0 0 0 0 0 8 9 17 
#Chair09
0 0 0 6 5 6 0 36 51 11 0 0 0 0 0 2 4 2 0 0 0 3 3 2 0 35 50 10 0 0 0 0 0 10 5 5 
#Chair08
0 0 0 8 4 6 0 32 50 8 0 0 0 0 0 2 4 2 0 0 0 3 3 3 0 34 56 13 0 0 0 0 0 10 4 3 
#Chair07
0 0 0 7 6 5 0 32 46 9 0 0 0 0 0 2 4 3 0 0 0 4 6 2 0 35 61 9 0 0 0 0 0 7 4 4 
#Chair06
0 0 0 7 5 5 0 38 50 11 0 0 0 0 0 3 4 3 0 0 0 3 4 3 0 34 53 11 0 0 0 0 0 7 3 3 
#Chair05
0 0 0 8 4 5 0 32 50 11 0 0 0 0 0 2 4 2 0 0 0 3 4 2 0 36 54 12 0 0 0 0 0 7 6 5 
#Chair04
0 0 0 7 7 7 0 31 49 7 0 0 0 0 0 3 5 3 0 0 0 3 4 3 0 34 56 9 0 0 0 0 0 8 5 6 
#Chair03
0 0 0 7 5 5 0 34 50 10 0 0 0 0 0 3 5 2 0 0 0 4 4 2 0 35 55 10 0 0 0 0 0 8 3 4 
#Chair02
0 0 0 8 3 7 0 35 49 11 0 0 0 0 0 4 4 3 0 0 0 2 4 3 0 35 51 11 0 0 0 0 0 7 5 5 
#Chair016
0 0 0 7 6 5 0 36 48 11 0 0 0 0 0 3 3 1 0 0 0 2 4 2 0 34 56 11 0 0 0 0 0 7 4 5 
#Chair015
0 0 0 7 4 5 0 36 51 10 0 0 0 0 0 3 3 2 0 0 0 4 3 3 0 36 52 12 0 0 0 0 0 8 4 3 
#Chair014
0 0 0 8 5 5 0 35 50 10 0 0 0 0 0 4 4 2 0 0 0 3 4 3 0 33 54 11 0 0 0 0 0 8 5 4 
#Chair013
0 0 0 6 5 5 0 35 50 12 0 0 0 0 0 3 2 3 0 0 0 3 4 3 0 35 55 9 0 0 0 0 0 8 6 5 
#Chair012
0 0 0 7 5 5 0 32 50 12 0 0 0 0 0 3 4 3 0 0 0 3 6 3 0 35 53 11 0 0 0 0 0 7 4 4 
#Chair011
0 0 0 7 5 6 0 35 46 10 0 0 0 0 0 3 4 3 0 0 0 2 5 3 0 34 58 12 0 0 0 0 0 7 3 5 
#Chair010
0 0 0 6 3 6 0 33 48 10 0 0 0 0 0 3 4 3 0 0 0 3 4 3 0 36 57 11 0 0 0 0 0 8 4 5 
#Chair01
0 0 0 8 5 4 0 30 50 11 0 0 0 0 0 3 5 3 0 0 0 3 5 3 0 33 55 13 0 0 0 0 0 6 5 4 
