#Sofa03
0 0 0 11 12 8 18 27 25 1 0 0 0 0 0 10 11 10 0 0 0 9 10 10 18 20 20 1 0 0 0 0 0 9 8 9 
#Sofa02
0 0 0 4 16 9 1 18 38 18 0 0 0 0 0 6 16 12 0 0 0 3 13 12 1 13 26 13 0 0 0 0 0 3 11 12 
#Sofa01
0 0 0 4 14 10 0 19 37 17 0 0 0 0 0 6 15 12 0 0 0 4 13 13 0 12 28 13 0 0 0 0 0 3 12 12 
#Chair02
0 0 0 0 16 13 0 0 0 13 52 11 0 0 0 0 15 8 0 0 0 0 15 9 0 0 0 11 50 10 0 0 0 0 15 10 
#Chair01
0 0 0 0 15 11 0 0 0 10 50 12 0 0 0 0 17 14 0 0 0 0 12 10 0 0 0 11 47 11 0 0 0 0 17 11 
#Carpet
0 0 0 9 12 9 9 24 28 6 0 0 0 0 0 10 13 9 0 0 0 8 11 9 7 23 26 6 0 0 0 0 0 11 10 8 
#Bonsai
0 0 0 0 17 4 1 5 16 51 13 0 0 0 0 1 7 4 0 0 0 0 6 16 1 3 19 43 16 0 0 0 0 0 22 1 
