#TV
0 0 0 2 3 3 3 3 6 4 7 8 9 9 10 10 9 10 11 14 12 12 12 11 11 11 9 8 6 8 6 5 2 1 2 0 
#Sofa
0 0 0 0 0 1 1 0 2 1 1 1 1 5 4 3 5 9 11 12 15 11 18 16 22 22 22 14 14 12 8 5 4 1 1 0 
#Notebook05
0 0 0 0 0 0 0 0 0 0 0 0 0 0 7 13 15 14 17 16 20 16 17 19 18 16 13 16 10 7 4 4 2 1 0 0 
#Notebook04
0 0 0 0 0 0 0 0 0 0 0 0 0 0 7 13 16 14 17 16 20 17 17 19 18 16 13 15 10 6 3 4 2 1 0 0 
#Notebook03
0 0 0 0 0 0 0 0 0 0 0 0 0 0 7 13 15 14 17 17 20 17 17 19 17 16 13 15 10 7 3 4 2 1 0 0 
#Notebook02
0 0 0 0 0 0 0 0 0 0 0 0 0 0 11 12 14 16 17 20 19 17 18 15 16 16 14 12 10 7 3 3 2 1 1 0 
#Notebook01
0 0 0 0 0 0 0 0 0 0 0 0 0 0 10 13 13 16 18 19 19 17 18 16 15 16 14 13 10 7 3 3 2 1 1 1 
#Globe
0 0 0 0 0 0 1 0 0 0 0 1 1 2 4 11 9 8 9 12 11 12 12 12 14 17 18 16 13 16 12 5 8 9 6 3 
#Desk
0 0 0 0 0 0 0 3 8 9 11 11 11 8 9 9 8 8 7 7 7 7 8 6 7 8 9 8 6 5 9 11 14 15 10 1 
#Chair09
0 0 1 1 3 4 4 4 5 8 9 13 9 12 11 11 9 16 13 15 16 15 12 8 5 4 4 3 4 4 3 3 3 2 1 0 
#Chair08
0 0 1 1 3 4 4 4 5 8 10 13 10 13 11 11 9 16 13 15 16 16 12 8 5 4 4 3 4 4 3 3 3 2 1 1 
#Chair07
0 0 2 2 2 2 5 4 6 9 11 11 10 11 10 11 9 16 14 16 16 14 9 8 5 4 6 5 3 4 5 4 2 2 3 1 
#Chair06
0 0 1 1 2 3 3 5 5 6 11 12 8 11 9 10 10 15 15 17 20 15 12 8 5 6 5 3 4 3 3 3 3 2 1 1 
#Chair05
0 0 1 1 2 3 3 4 5 6 11 12 8 11 9 10 10 16 14 17 20 14 11 8 6 6 5 4 4 3 4 2 3 1 1 1 
#Chair04
0 0 1 3 2 2 3 6 5 8 9 13 8 12 12 13 8 14 16 16 17 16 11 8 4 5 5 3 5 4 2 3 3 1 2 0 
#Chair03
0 0 1 1 2 3 5 5 6 9 9 13 9 12 11 10 10 14 14 15 16 13 11 6 6 5 4 5 4 3 3 4 4 3 1 2 
#Chair02
0 0 1 2 2 3 4 4 5 8 10 13 8 10 9 12 6 17 15 15 15 18 11 9 3 4 5 4 4 3 4 4 3 2 2 1 
#Chair013
0 0 0 0 0 0 0 0 0 0 1 2 1 3 8 12 24 13 12 16 25 20 24 20 18 5 6 6 4 5 5 4 3 3 2 0 
#Chair012
0 0 0 0 0 0 0 0 0 0 1 2 2 3 7 14 22 15 10 17 28 19 23 16 22 3 6 3 3 5 6 5 5 3 3 1 
#Chair011
0 0 0 0 0 0 0 0 1 8 8 6 8 8 11 13 15 17 15 15 12 10 8 7 5 7 7 3 6 12 12 12 9 5 2 0 
#Chair010
0 0 1 1 1 3 4 4 4 7 10 12 12 11 9 12 9 18 12 13 17 13 10 9 5 7 4 5 5 5 4 3 4 3 1 1 
#Chair01
0 0 1 2 2 3 4 4 4 6 10 12 12 11 9 12 10 17 13 12 17 13 10 9 5 7 4 5 5 5 4 3 3 3 1 1 
#Bookshelf02
0 0 0 1 2 4 4 3 5 4 5 6 4 7 8 11 12 10 18 13 11 8 13 13 11 7 9 11 9 9 9 5 3 2 2 1 
#Bookshelf01
0 0 0 0 1 2 4 5 5 5 4 7 5 7 7 10 8 12 14 12 11 11 14 10 11 8 9 9 12 9 9 6 4 3 2 1 
