#TV
13 37 48 50 44 33 18 8 1 0 
#Sofa
4 18 32 48 53 50 34 11 1 0 
#Notebook05
11 31 43 49 50 39 22 7 1 0 
#Notebook04
11 31 44 49 49 39 21 6 1 0 
#Notebook03
11 31 43 49 50 39 21 6 1 0 
#Notebook02
11 32 45 50 50 38 19 6 1 0 
#Notebook01
11 32 45 50 49 38 20 6 1 0 
#Globe
6 21 39 50 50 48 24 10 3 0 
#Desk
22 47 48 36 29 23 19 15 10 2 
#Chair09
14 36 54 63 50 24 8 2 0 0 
#Chair08
14 36 54 63 50 24 8 2 0 0 
#Chair07
14 36 53 62 50 25 9 3 0 0 
#Chair06
13 34 52 62 52 26 9 2 0 0 
#Chair05
13 34 53 62 52 26 9 2 0 0 
#Chair04
14 35 54 64 51 24 8 2 0 0 
#Chair03
14 35 52 62 51 26 9 3 1 0 
#Chair02
14 34 52 62 51 26 9 3 0 0 
#Chair013
9 31 47 51 48 38 22 7 0 0 
#Chair012
8 31 46 52 48 37 21 8 1 0 
#Chair011
11 40 57 64 48 22 8 2 0 0 
#Chair010
14 35 51 61 51 26 10 3 1 0 
#Chair01
14 34 51 62 51 27 10 3 1 0 
#Bookshelf02
10 33 43 50 49 35 19 9 2 0 
#Bookshelf01
10 32 42 49 49 36 19 10 3 0 
