#Desk
0 0 2 2 4 5 5 7 8 8 8 9 9 11 8 11 12 13 9 7 7 7 7 17 16 11 9 4 4 3 5 3 3 3 2 2 
#Chair08
0 0 1 2 4 3 3 4 5 6 6 5 9 13 16 13 14 14 12 12 13 11 9 8 4 3 3 4 3 3 5 7 9 7 5 4 
#Chair07
0 0 1 2 4 3 4 4 5 6 6 5 8 13 16 14 13 14 12 12 12 11 8 8 4 3 3 4 3 3 5 7 9 7 5 4 
#Chair06
0 0 1 2 3 4 4 4 7 7 7 5 9 10 15 15 12 14 14 9 9 8 11 6 4 4 3 3 3 3 5 9 11 8 8 3 
#Chair05
0 0 1 1 3 4 4 5 6 6 6 5 7 11 14 17 12 16 14 10 10 9 9 9 6 3 3 3 3 3 4 8 10 8 7 2 
#Chair04
0 0 1 1 3 4 3 4 5 6 7 5 7 16 15 18 13 13 12 10 9 9 9 8 5 3 3 2 4 3 5 8 9 8 7 3 
#Chair03
0 0 1 2 3 4 2 4 5 6 7 5 8 16 15 17 12 13 13 11 9 8 9 8 5 3 3 2 4 3 5 8 9 8 7 3 
#Chair02
0 0 1 2 2 3 5 6 4 4 5 8 7 13 14 15 13 14 11 9 11 9 8 8 7 5 4 4 4 5 6 8 12 7 4 4 
#Chair01
0 0 1 1 4 3 3 5 4 6 6 5 7 13 15 16 13 13 13 11 10 10 9 8 6 4 5 3 4 2 4 9 9 7 8 4 
#CellPhone
0 0 0 1 2 3 3 3 6 4 5 5 5 6 7 8 8 14 13 9 8 11 9 8 9 8 7 6 6 8 8 7 7 14 9 10 
#Book02
0 0 1 2 2 4 4 4 3 5 7 7 6 7 8 11 10 11 13 14 12 12 10 12 11 10 9 8 9 8 6 3 4 2 2 0 
#Book01
0 1 1 1 3 2 4 4 6 4 7 7 8 7 8 9 10 14 13 14 13 10 10 13 9 9 11 7 10 6 7 4 2 2 1 0 
