#WallLight05
0 0 0 0 0 0 0 0 0 0 0 0 3 4 6 13 17 13 13 9 11 10 14 14 12 17 22 16 11 8 6 7 10 4 4 1 
#WallLight04
0 0 0 0 0 0 0 0 0 0 0 0 3 4 6 13 17 13 13 9 11 10 13 14 12 17 22 17 10 9 6 7 10 4 3 1 
#WallLight03
0 0 0 0 0 0 0 0 0 0 0 0 4 5 6 13 13 14 13 9 10 9 11 16 14 16 16 19 13 8 8 9 10 5 4 0 
#WallLight02
0 0 0 0 0 0 0 0 0 0 0 0 4 5 6 14 13 14 12 9 11 10 12 15 14 16 17 19 12 8 7 9 10 5 3 1 
#WallLight01
0 0 0 0 0 0 0 0 0 0 0 0 4 5 6 13 13 14 13 9 10 9 12 15 14 16 16 19 12 8 7 9 10 6 3 0 
#Table02
0 0 0 0 0 0 0 0 0 0 0 0 0 0 3 9 11 14 13 9 10 10 7 9 7 7 7 11 19 30 33 18 8 7 2 1 
#Table01
0 0 0 0 0 0 0 0 0 0 0 0 0 0 0 0 0 1 3 6 7 13 15 20 19 29 28 29 27 19 11 8 5 3 2 0 
#Sofa02
0 0 0 0 0 1 1 2 3 4 4 7 7 7 7 7 10 13 18 17 20 18 14 12 14 9 9 7 4 5 5 4 3 4 2 1 
#Sofa01
0 0 0 0 1 1 2 1 1 3 5 6 7 6 6 7 11 13 18 16 20 18 15 12 15 10 9 6 5 5 4 2 5 4 3 0 
#Screen
0 1 2 3 3 6 5 6 6 6 7 7 8 9 7 11 12 11 11 12 11 13 13 12 11 8 10 8 5 5 5 2 2 1 1 0 
#Picture
0 0 1 1 1 3 3 4 5 4 5 4 5 6 8 11 12 12 13 12 12 7 9 9 8 8 7 9 11 9 12 11 7 7 3 2 
#Lamp
0 0 1 2 0 1 0 0 3 1 2 3 3 4 8 5 5 6 6 13 13 18 12 10 8 8 9 10 11 12 19 16 10 7 9 2 
#Desk
0 0 1 1 2 1 2 2 3 4 3 5 4 7 12 12 13 13 14 9 15 18 16 15 14 9 8 9 8 5 3 3 3 2 1 2 
#Chair09
0 0 0 0 0 1 3 7 9 7 8 10 13 15 12 12 8 14 16 15 11 9 11 10 10 8 5 5 4 4 3 3 2 3 1 2 
#Chair08
0 0 0 0 0 1 2 8 8 8 9 14 15 15 11 12 10 14 15 12 11 10 8 8 9 5 6 5 3 4 5 2 3 3 2 1 
#Chair07
0 0 0 0 0 1 3 5 8 9 10 11 13 14 13 9 9 13 16 13 12 11 10 9 10 6 4 3 6 4 4 3 4 4 2 1 
#Chair06
0 0 0 0 0 1 2 7 9 7 10 10 15 17 10 11 8 13 15 16 9 11 9 12 8 7 5 4 4 3 4 4 3 2 2 0 
#Chair05
0 0 0 0 0 2 4 6 7 7 11 11 15 16 9 8 8 12 19 13 12 10 13 12 10 6 5 4 5 4 4 4 3 2 2 0 
#Chair04
0 0 0 0 0 2 3 6 7 7 9 11 16 14 12 11 9 12 18 12 13 11 9 11 11 6 3 5 4 2 3 3 4 2 2 1 
#Chair03
0 0 0 0 0 1 3 6 6 8 10 11 15 16 10 9 9 16 15 13 12 11 11 11 11 5 5 3 3 3 5 4 2 3 2 1 
#Chair02
0 0 0 0 0 1 3 8 7 7 12 11 15 17 12 10 8 11 18 13 9 11 9 10 10 6 4 4 3 4 4 4 3 3 1 1 
#Chair010
0 0 0 0 0 1 3 6 7 9 8 11 16 16 10 10 9 12 15 13 14 9 9 11 11 7 4 5 5 5 3 4 3 3 2 0 
#Chair01
0 0 0 0 0 1 3 7 7 8 10 12 15 16 11 11 7 13 18 12 13 9 9 9 10 6 5 5 2 5 4 4 2 2 2 1 
#CellingLight
0 1 0 2 4 2 3 2 4 3 13 13 13 19 23 15 5 0 1 1 2 6 3 3 1 4 6 16 16 9 10 7 13 7 5 5 
