#WallLight05
0 0 0 11 24 9 0 0 31 19 1 0 0 0 0 11 23 8 0 0 0 6 18 8 0 0 28 17 0 0 0 0 0 7 19 8 
#WallLight04
0 0 0 10 24 9 0 0 31 20 1 0 0 0 0 10 24 8 0 0 0 6 18 8 0 0 27 17 0 0 0 0 0 7 20 8 
#WallLight03
0 0 0 12 22 8 0 0 32 17 0 0 0 0 0 11 26 10 0 0 0 6 19 8 0 0 25 17 0 0 0 0 0 6 19 9 
#WallLight02
0 0 0 12 22 8 0 0 32 16 0 0 0 0 0 12 25 11 0 0 0 6 20 9 0 0 25 17 0 0 0 0 0 5 18 9 
#WallLight01
0 0 0 12 22 8 0 0 33 17 0 0 0 0 0 11 25 11 0 0 0 6 19 8 0 0 25 17 0 0 0 0 0 5 19 9 
#Table02
0 0 0 0 20 14 0 0 19 30 2 0 0 0 0 1 20 20 0 0 0 0 19 19 0 0 19 27 2 0 0 0 0 0 18 17 
#Table01
0 0 0 1 18 3 0 0 0 29 30 4 0 0 0 0 26 8 0 0 0 1 15 3 0 0 0 33 35 5 0 0 0 0 28 7 
#Sofa02
0 0 0 4 10 7 1 10 25 46 4 0 0 0 0 1 9 2 0 0 0 2 8 2 1 13 28 42 6 1 0 0 0 4 12 7 
#Sofa01
0 0 0 5 11 6 1 12 28 42 6 2 0 0 0 2 9 2 0 0 0 3 9 2 1 9 23 42 5 1 0 0 0 5 12 6 
#Screen
0 0 0 8 9 3 9 21 32 21 7 0 0 0 0 9 10 3 0 0 0 9 8 2 7 17 28 19 6 0 0 0 0 6 8 3 
#Picture
0 0 0 4 12 9 5 15 29 21 1 0 0 0 0 4 13 10 0 0 0 5 12 12 2 12 26 24 1 0 0 0 0 4 13 12 
#Lamp
0 0 0 2 18 11 3 6 17 29 0 0 0 0 0 3 12 18 0 0 0 3 11 21 2 5 16 34 0 0 0 0 0 2 18 14 
#Desk
0 0 0 8 15 7 1 9 43 55 12 0 0 0 0 10 15 2 0 0 0 7 8 6 6 11 20 4 0 0 0 0 0 2 4 2 
#Chair09
0 0 0 8 13 6 0 25 36 27 4 1 0 0 0 0 2 1 0 0 0 0 2 1 0 22 38 26 3 0 0 0 0 11 12 6 
#Chair08
0 0 0 9 13 10 0 24 39 23 3 0 0 0 0 0 1 1 0 0 0 0 1 1 1 26 40 24 2 1 0 0 0 9 12 6 
#Chair07
0 0 0 10 13 9 0 22 36 27 3 1 0 0 0 0 1 0 0 0 0 0 1 1 1 25 39 27 3 1 0 0 0 9 13 6 
#Chair06
0 0 0 11 12 6 1 26 37 27 3 0 0 0 0 0 1 0 0 0 0 0 1 2 0 23 39 28 3 0 0 0 0 8 11 7 
#Chair05
0 0 0 9 14 7 1 24 35 31 3 0 0 0 0 0 2 1 0 0 0 0 2 1 1 23 34 28 3 0 0 0 0 10 11 6 
#Chair04
0 0 0 11 12 8 1 23 36 27 3 1 0 0 0 0 1 0 0 0 0 0 1 1 1 21 39 26 3 0 0 0 0 10 12 6 
#Chair03
0 0 0 9 11 8 0 20 41 28 5 1 0 0 0 0 1 0 0 0 0 0 1 0 0 25 38 27 2 1 0 0 0 9 11 7 
#Chair02
0 0 0 8 11 7 0 25 39 26 3 1 0 0 0 0 2 1 0 0 0 0 1 1 0 25 37 26 5 0 0 0 0 10 11 7 
#Chair010
0 0 0 11 14 7 0 25 38 27 2 0 0 0 0 0 2 1 0 0 0 0 2 0 0 21 37 24 2 0 0 0 0 11 14 7 
#Chair01
0 0 0 11 13 7 0 23 39 26 3 0 0 0 0 0 1 0 0 0 0 0 1 1 1 25 37 26 4 0 0 0 0 9 12 7 
#CellingLight
0 0 0 2 0 4 6 21 36 3 25 9 0 0 0 0 0 10 0 0 0 0 0 6 6 20 42 5 28 16 0 0 0 5 0 2 
