#WallLight05
10 29 43 37 32 41 36 19 4 0 
#WallLight04
10 29 43 37 32 41 36 19 4 0 
#WallLight03
10 28 42 38 34 40 36 19 4 0 
#WallLight02
10 28 42 38 33 40 37 19 4 0 
#WallLight01
10 28 42 38 34 40 36 19 4 0 
#Table02
14 28 36 50 36 28 23 27 10 0 
#Table01
12 25 32 37 47 49 32 15 2 0 
#Sofa02
7 28 45 53 55 40 17 5 1 0 
#Sofa01
7 28 44 53 54 40 19 5 1 0 
#Screen
16 39 52 52 42 31 16 4 0 0 
#Picture
13 32 42 46 44 33 21 13 6 0 
#Lamp
10 29 40 44 34 29 30 21 13 1 
#Desk
15 36 51 50 44 29 16 7 1 0 
#Chair09
15 41 58 59 47 22 7 2 0 0 
#Chair08
16 44 59 59 45 21 6 1 0 0 
#Chair07
15 42 58 59 46 23 7 2 0 0 
#Chair06
15 43 59 60 45 21 6 1 0 0 
#Chair05
15 41 59 59 46 23 6 2 0 0 
#Chair04
15 43 59 60 46 21 6 1 0 0 
#Chair03
15 41 58 61 47 22 6 1 0 0 
#Chair02
15 43 59 60 46 22 7 1 0 0 
#Chair010
15 43 60 60 45 21 6 2 0 0 
#Chair01
16 44 61 61 45 20 5 1 0 0 
#CellingLight
13 29 33 52 57 34 20 11 2 0 
