#TV
0 0 0 2 6 13 11 12 16 16 13 14 11 7 3 0 0 0 0 0 0 2 8 12 15 11 13 13 13 11 12 8 4 0 0 0 
#Desk
0 1 1 7 7 10 11 13 14 11 12 9 10 7 5 2 2 0 0 0 1 6 7 11 9 11 10 13 14 10 11 7 6 1 1 0 
#Chair09
0 0 0 0 2 8 7 33 22 10 12 7 8 6 4 6 0 0 0 0 6 4 4 7 6 10 11 27 27 5 5 2 2 0 0 0 
#Chair08
0 0 0 0 3 6 5 29 22 13 11 6 9 8 5 4 0 0 0 0 6 5 5 7 7 11 13 23 27 6 7 4 1 0 0 0 
#Chair07
0 0 0 2 2 6 6 32 22 11 12 6 7 5 6 6 0 0 0 0 4 4 5 7 6 12 11 23 25 6 10 3 2 0 0 0 
#Chair06
0 0 0 1 3 7 7 30 22 12 12 7 8 6 4 4 0 0 0 0 5 5 6 6 8 11 9 26 26 6 6 3 2 1 0 0 
#Chair05
0 0 0 0 1 6 8 30 24 11 11 8 7 5 4 5 0 0 0 0 4 5 6 8 6 12 13 23 29 5 7 3 1 0 0 0 
#Chair04
0 0 0 2 3 7 7 31 19 13 10 7 9 6 3 5 0 0 0 0 4 4 7 7 6 11 13 23 26 7 8 2 1 0 0 0 
#Chair03
0 0 0 1 2 7 7 29 22 14 9 5 9 6 7 5 0 0 0 0 4 4 6 7 6 11 12 23 28 7 7 3 1 0 0 0 
#Chair022
0 0 0 1 3 7 6 27 20 11 12 7 7 6 3 4 0 0 0 0 5 5 4 7 7 14 12 24 30 9 5 4 2 0 0 0 
#Chair021
0 0 0 1 3 8 6 32 23 14 11 6 10 6 5 5 0 0 0 0 5 5 4 7 7 10 10 19 28 7 7 2 1 0 0 0 
#Chair020
0 0 0 1 2 6 5 30 21 14 10 8 8 6 4 6 0 0 0 0 5 4 5 8 7 13 11 24 28 7 6 2 1 0 0 0 
#Chair02
0 0 0 1 4 5 8 28 23 11 10 6 8 6 3 4 0 0 0 0 5 4 6 7 6 11 11 26 31 7 6 3 1 0 0 0 
#Chair019
0 0 0 1 3 7 6 30 21 11 11 7 8 4 6 6 0 0 0 0 5 4 4 7 7 12 10 24 31 6 7 2 1 0 0 0 
#Chair018
0 0 0 1 3 7 8 32 23 10 11 6 9 7 2 7 0 0 0 0 5 4 6 7 6 12 12 21 27 6 7 4 1 0 0 0 
#Chair017
0 0 0 1 2 7 8 26 21 13 10 9 7 6 4 6 0 0 0 0 5 5 4 6 6 12 12 25 29 6 7 3 1 0 0 0 
#Chair016
0 0 0 1 3 7 7 28 23 12 10 7 8 6 4 5 0 0 0 0 6 4 6 8 6 13 11 20 30 7 6 3 1 0 0 0 
#Chair015
0 0 0 1 1 7 5 31 25 11 11 6 7 4 5 4 0 0 0 0 6 5 5 6 7 12 13 25 28 6 7 2 2 0 0 0 
#Chair014
0 0 0 1 3 6 6 29 24 12 12 7 7 4 3 6 0 0 0 0 5 4 6 8 7 11 12 23 27 7 7 3 1 0 0 0 
#Chair013
0 0 0 1 2 5 6 31 21 10 12 7 7 5 4 4 0 0 0 0 7 6 7 8 7 12 11 22 28 5 7 3 1 0 0 0 
#Chair012
0 0 0 1 2 6 7 30 23 11 11 5 7 6 6 6 0 0 0 0 5 4 6 7 5 12 12 21 30 8 7 3 1 0 0 0 
#Chair011
0 0 0 2 3 6 6 33 21 11 10 6 6 6 5 5 0 0 0 0 5 4 4 7 8 12 12 24 28 7 7 2 1 0 0 0 
#Chair010
0 0 0 1 2 7 7 29 21 11 10 9 9 6 4 5 0 0 0 0 4 4 6 8 7 11 13 21 26 7 9 3 2 0 0 0 
#Chair01
0 0 0 1 3 8 5 34 24 11 11 8 8 6 4 7 0 0 0 0 3 4 5 6 7 10 12 22 25 6 7 2 1 0 0 0 
#Bonsai
0 0 0 0 1 7 6 7 6 6 4 15 20 15 13 10 11 0 0 11 11 11 19 18 17 3 7 7 5 8 5 1 0 0 0 0 
