#TV
0 0 0 2 2 5 5 5 6 6 7 9 7 10 12 12 13 11 13 14 13 11 12 12 12 9 8 7 6 5 3 2 2 2 1 0 
#Desk
0 2 2 4 7 7 11 11 10 11 11 8 6 10 8 7 7 7 7 8 9 8 8 9 7 7 5 6 6 7 10 4 2 2 4 1 
#Chair09
0 0 0 0 0 2 4 3 4 9 10 10 12 9 13 14 17 19 19 15 9 6 7 7 7 3 3 3 3 4 4 3 6 8 5 3 
#Chair08
0 0 0 0 0 1 2 3 5 11 10 10 10 9 14 13 18 17 15 14 10 8 7 7 7 5 5 5 4 3 4 4 6 6 4 3 
#Chair07
0 0 0 0 0 1 3 2 5 9 8 8 10 8 13 17 19 19 16 14 7 7 8 7 7 7 3 3 5 5 5 3 6 8 4 4 
#Chair06
0 0 0 0 0 1 3 2 5 8 9 6 12 9 12 16 17 19 20 13 10 7 6 9 8 4 5 4 4 3 4 3 5 8 4 2 
#Chair05
0 0 0 0 0 2 2 3 4 9 7 10 10 9 15 14 19 20 18 15 10 7 6 7 7 3 5 3 4 4 3 3 5 7 4 3 
#Chair04
0 0 0 0 0 1 3 1 6 7 11 6 11 9 14 16 18 15 20 14 11 8 9 7 8 5 6 3 4 4 3 3 3 5 6 3 
#Chair03
0 0 0 0 0 1 3 3 6 8 9 10 11 10 13 14 16 17 15 18 9 9 7 8 7 5 5 5 3 3 4 4 5 6 5 2 
#Chair022
0 0 0 0 0 1 2 3 5 8 7 11 11 10 12 14 16 20 18 17 11 7 6 8 6 6 4 3 5 3 3 3 5 8 6 3 
#Chair021
0 0 0 0 0 1 2 2 4 8 8 9 10 8 14 14 18 17 20 14 9 7 8 9 6 6 5 4 3 4 4 4 5 7 4 3 
#Chair020
0 0 0 0 0 2 1 3 4 8 8 10 12 11 14 14 15 19 19 12 12 8 7 7 7 5 4 4 5 3 3 3 4 9 5 3 
#Chair02
0 0 0 0 0 1 3 4 4 8 7 8 12 8 12 14 19 17 23 17 11 6 6 9 9 5 5 5 3 3 2 4 4 7 4 3 
#Chair019
0 0 0 0 0 2 3 4 6 8 8 9 10 9 12 17 13 18 16 17 11 7 6 9 6 3 4 4 4 3 3 4 6 9 5 2 
#Chair018
0 0 0 0 0 2 3 3 4 8 9 11 10 6 11 15 18 17 20 15 8 8 8 7 7 7 5 4 4 4 2 4 3 8 4 2 
#Chair017
0 0 0 0 0 2 2 3 4 9 8 10 11 9 13 13 17 19 18 14 9 8 7 7 7 7 4 4 4 3 4 4 4 7 4 3 
#Chair016
0 0 0 0 0 1 3 4 4 9 10 9 9 10 13 16 15 18 18 15 9 8 8 8 6 6 5 4 4 3 4 3 5 7 6 2 
#Chair015
0 0 0 0 0 2 3 2 4 10 8 10 10 9 11 17 20 19 20 13 9 6 4 8 7 5 4 4 3 3 4 4 4 8 5 3 
#Chair014
0 0 0 0 0 1 2 2 5 9 9 9 11 9 13 16 16 20 19 15 9 7 7 8 7 4 4 4 3 3 5 4 5 7 4 4 
#Chair013
0 0 0 0 0 2 2 2 3 9 9 8 10 10 13 17 15 21 19 13 9 5 7 6 8 6 5 4 5 4 3 3 4 9 4 3 
#Chair012
0 0 0 0 0 1 3 4 5 9 10 8 8 9 14 13 17 17 20 13 9 7 7 7 8 4 6 4 4 4 4 4 4 6 5 3 
#Chair011
0 0 0 0 0 2 2 4 6 8 10 10 10 9 13 19 15 18 17 14 12 5 6 8 7 5 4 3 4 4 2 3 5 9 4 3 
#Chair010
0 0 0 0 0 2 2 2 5 11 8 8 8 8 13 14 17 18 19 16 8 8 8 8 8 5 5 5 3 4 3 4 5 6 4 3 
#Chair01
0 0 0 0 0 2 2 2 4 8 8 11 10 8 14 16 18 19 17 16 8 7 8 7 6 5 5 3 4 5 3 3 4 8 5 2 
#Bonsai
0 0 2 4 6 4 5 5 3 4 3 2 2 1 1 5 9 18 10 10 10 10 8 10 10 7 7 12 8 9 9 7 9 8 4 20 
