#TV
15 42 53 52 42 27 15 5 0 0 
#Desk
28 59 47 37 29 22 15 9 3 0 
#Chair09
12 32 52 59 48 30 13 5 1 0 
#Chair08
11 32 52 59 48 29 13 5 1 0 
#Chair07
11 30 49 59 49 31 13 6 2 0 
#Chair06
11 31 51 60 50 30 13 5 2 0 
#Chair05
12 31 51 60 49 30 12 4 1 0 
#Chair04
11 30 51 60 50 30 13 5 1 0 
#Chair03
11 31 51 60 48 30 13 5 1 0 
#Chair022
11 30 50 61 50 30 13 5 2 0 
#Chair021
11 30 50 60 49 31 14 5 1 0 
#Chair020
12 31 51 60 49 30 13 4 1 0 
#Chair02
11 31 51 60 50 30 13 4 1 0 
#Chair019
11 31 51 59 48 31 13 5 1 0 
#Chair018
11 31 51 59 49 31 13 5 1 0 
#Chair017
11 31 51 60 49 30 13 5 1 0 
#Chair016
11 31 52 60 48 30 13 5 1 0 
#Chair015
12 31 51 60 49 30 12 5 1 0 
#Chair014
11 30 50 61 49 30 13 5 2 0 
#Chair013
12 30 50 59 49 31 13 5 2 0 
#Chair012
11 31 52 59 48 31 14 5 1 0 
#Chair011
11 31 52 60 48 30 13 5 2 0 
#Chair010
11 30 51 60 49 30 13 5 1 0 
#Chair01
11 31 51 60 49 30 13 5 1 0 
#Bonsai
28 81 46 24 24 21 17 9 2 0 
