#Desk
0 1 1 2 4 10 20 10 9 10 9 15 11 6 4 1 0 0 0 0 1 3 5 14 19 11 9 11 10 18 13 5 3 2 1 0 
#Chair08
0 0 1 2 4 7 8 20 21 16 11 10 8 5 5 5 1 0 0 0 6 5 6 5 7 10 13 22 21 8 8 3 2 0 0 0 
#Chair07
0 0 1 1 3 9 8 21 21 14 8 10 7 6 5 6 0 0 0 0 5 5 6 7 7 11 13 21 23 8 9 3 2 0 0 0 
#Chair06
0 0 2 2 4 9 7 21 21 15 11 10 4 7 5 5 0 0 0 1 6 3 6 8 9 12 14 18 18 10 9 2 1 1 0 0 
#Chair05
0 0 0 2 3 10 9 20 19 15 10 7 8 6 4 6 0 0 0 1 5 5 5 6 9 8 15 23 23 8 9 3 2 0 0 0 
#Chair04
0 0 0 2 3 8 10 20 16 17 13 8 6 5 4 6 1 0 0 1 4 5 7 6 10 9 15 20 18 9 9 4 2 0 0 0 
#Chair03
0 0 0 3 3 8 8 17 20 16 9 9 5 6 7 4 0 0 0 0 4 5 5 7 10 9 14 23 20 8 11 5 2 1 0 0 
#Chair02
0 0 0 3 3 8 8 19 24 13 10 10 5 7 5 6 0 0 0 0 5 3 7 6 9 11 13 23 20 7 8 3 2 0 0 0 
#Chair01
0 0 1 2 4 7 10 18 18 14 9 9 7 5 6 5 0 0 0 0 6 5 6 6 9 8 17 22 22 7 10 4 2 1 0 0 
