#TV
0 0 0 9 10 2 6 21 33 23 0 0 0 0 0 7 11 3 0 0 0 7 11 2 4 18 34 19 1 0 0 0 0 9 11 3 
#Desk
0 0 0 11 11 6 12 33 24 1 0 0 0 0 0 11 10 6 0 0 0 12 10 5 12 31 23 2 0 0 0 0 0 13 8 6 
#Chair09
0 0 0 3 3 4 1 20 45 24 2 0 0 0 0 7 8 10 0 0 0 5 7 9 1 22 41 21 1 1 0 0 0 2 3 4 
#Chair08
0 0 0 2 5 4 0 21 41 22 1 0 0 0 0 7 10 9 0 0 0 6 7 10 0 22 42 21 2 0 0 0 0 3 5 4 
#Chair07
0 0 0 2 4 5 0 19 46 22 2 0 0 0 0 6 9 9 0 0 0 6 8 8 1 17 43 21 2 1 0 0 0 3 6 7 
#Chair06
0 0 0 2 6 3 0 17 45 25 1 1 0 0 0 7 8 8 0 0 0 5 9 9 0 20 41 23 2 0 0 0 0 2 4 6 
#Chair05
0 0 0 2 4 3 1 19 45 25 2 1 0 0 0 5 8 8 0 0 0 7 9 8 1 18 45 22 0 0 0 0 0 2 4 6 
#Chair04
0 0 0 2 5 6 0 16 45 25 1 1 0 0 0 7 8 8 0 0 0 6 11 7 1 19 40 25 1 0 0 0 0 3 5 4 
#Chair03
0 0 0 2 5 3 0 21 41 23 0 1 0 0 0 7 9 11 0 0 0 6 8 7 0 20 42 23 2 0 0 0 0 4 3 4 
#Chair022
0 0 0 3 4 6 0 19 42 21 1 0 0 0 0 6 9 7 0 0 0 6 7 8 1 19 43 30 2 1 0 0 0 2 4 5 
#Chair021
0 0 0 4 4 4 1 20 45 24 2 0 0 0 0 7 10 8 0 0 0 6 7 9 0 16 38 24 2 1 0 0 0 3 4 4 
#Chair020
0 0 0 2 3 4 1 18 45 23 2 0 0 0 0 6 9 9 0 0 0 6 8 8 1 19 42 26 2 0 0 0 0 2 4 4 
#Chair02
0 0 0 2 5 4 0 18 40 27 1 1 0 0 0 7 9 7 0 0 0 5 9 8 1 18 44 27 2 0 0 0 0 3 5 4 
#Chair019
0 0 0 3 4 5 1 19 41 24 2 0 0 0 0 7 7 11 0 0 0 6 6 8 1 21 42 24 1 1 0 0 0 3 3 4 
#Chair018
0 0 0 2 4 4 1 21 40 27 1 1 0 0 0 7 10 8 0 0 0 5 10 7 1 20 39 22 1 0 0 0 0 3 5 4 
#Chair017
0 0 0 3 5 3 1 18 41 25 1 0 0 0 0 6 9 9 0 0 0 4 8 9 0 21 44 23 2 0 0 0 0 2 5 4 
#Chair016
0 0 0 3 5 3 0 22 43 21 1 0 0 0 0 6 10 8 0 0 0 7 8 9 0 18 41 26 1 0 0 0 0 3 3 4 
#Chair015
0 0 0 2 4 4 0 21 44 21 1 1 0 0 0 5 8 7 0 0 0 5 7 10 1 19 44 24 1 0 0 0 0 2 6 4 
#Chair014
0 0 0 2 4 4 1 20 44 23 2 0 0 0 0 6 6 9 0 0 0 6 7 9 0 19 41 25 2 1 0 0 0 3 4 6 
#Chair013
0 0 0 1 5 3 0 21 43 22 1 1 0 0 0 5 9 7 0 0 0 6 11 11 1 16 45 22 1 0 0 0 0 3 5 5 
#Chair012
0 0 0 2 4 3 1 20 41 23 2 0 0 0 0 5 9 11 0 0 0 6 8 9 0 22 39 25 2 0 0 0 0 3 5 4 
#Chair011
0 0 0 2 4 5 1 21 43 21 1 0 0 0 0 5 10 8 0 0 0 6 6 8 0 19 43 26 0 1 0 0 0 2 6 3 
#Chair010
0 0 0 3 4 3 1 20 40 25 1 0 0 0 0 7 8 9 0 0 0 6 10 7 0 19 41 22 2 0 0 0 0 4 5 6 
#Chair01
0 0 0 3 5 5 1 20 47 24 1 1 0 0 0 7 9 10 0 0 0 5 8 6 0 18 41 21 2 0 0 0 0 3 5 4 
#Bonsai
0 0 0 2 5 1 8 12 18 7 0 0 0 0 0 20 21 28 0 0 0 20 23 28 9 11 20 7 0 0 0 0 0 2 3 0 
