#Speaker02
0 0 0 0 12 18 0 0 3 34 30 0 0 0 0 0 13 20 0 0 0 0 14 13 0 0 6 39 16 0 0 0 0 0 15 14 
#Speaker01
0 0 0 0 13 18 0 0 4 34 30 0 0 0 0 0 13 19 0 0 0 0 14 13 0 0 6 39 16 0 0 0 0 0 15 14 
#Screen
0 0 0 7 10 3 6 19 30 22 2 0 0 0 0 6 9 2 0 0 0 7 10 3 4 17 30 28 6 0 0 0 0 8 13 2 
#Projector
0 0 0 1 12 14 0 2 17 30 19 1 0 0 0 1 10 16 0 0 0 1 11 14 0 2 16 35 14 0 0 0 0 0 12 16 
#Notebook
0 0 0 7 9 4 0 0 26 41 19 0 0 0 0 7 11 3 0 0 0 7 9 3 0 0 26 39 19 0 0 0 0 7 8 2 
#DVDTray
0 0 0 6 13 7 4 15 26 24 3 0 0 0 0 5 12 8 0 0 0 7 12 6 4 16 28 21 4 0 0 0 0 6 12 7 
#DVD
0 0 0 4 15 10 0 11 18 30 9 0 0 0 0 4 12 11 0 0 0 4 13 10 0 10 20 27 9 0 0 0 0 3 13 11 
#Desk
0 0 0 13 11 6 11 23 22 4 0 0 0 0 0 12 12 5 0 0 0 17 12 4 13 26 21 7 0 0 0 0 0 13 10 6 
#Chair09
0 0 0 2 10 7 4 12 18 19 6 0 0 0 0 8 14 19 0 0 0 10 11 16 6 13 22 22 7 0 0 0 0 2 10 7 
#Chair08
0 0 0 2 10 6 4 14 20 18 7 0 0 0 0 8 13 19 0 0 0 10 12 15 5 14 22 22 6 0 0 0 0 2 11 6 
#Chair07
0 0 0 2 10 6 4 15 20 18 7 0 0 0 0 9 13 19 0 0 0 10 12 16 5 14 21 22 6 0 0 0 0 1 11 6 
#Chair06
0 0 0 3 12 6 3 13 19 20 7 0 0 0 0 9 11 20 0 0 0 9 13 15 4 15 20 22 6 0 0 0 0 1 10 6 
#Chair05
0 0 0 3 11 7 3 14 20 21 7 0 0 0 0 9 11 20 0 0 0 9 13 15 4 15 20 22 6 0 0 0 0 1 10 6 
#Chair04
0 0 0 3 12 6 3 13 19 20 7 0 0 0 0 9 11 20 0 0 0 9 13 15 4 15 20 22 6 0 0 0 0 1 11 6 
#Chair03
0 0 0 1 9 6 5 13 20 21 7 0 0 0 0 8 14 19 0 0 0 8 14 19 6 16 20 19 6 0 0 0 0 2 7 7 
#Chair02
0 0 0 1 9 6 5 13 20 21 7 0 0 0 0 8 14 20 0 0 0 7 14 19 5 15 19 19 6 0 0 0 0 2 7 7 
#Chair014
0 0 0 1 10 6 4 12 19 19 6 0 0 0 0 10 12 19 0 0 0 10 12 20 5 14 20 20 7 0 0 0 0 1 8 7 
#Chair013
0 0 0 1 9 6 5 13 20 21 7 0 0 0 0 7 14 19 0 0 0 8 13 19 6 16 20 19 6 0 0 0 0 1 7 7 
#Chair012
0 0 0 2 10 7 5 11 22 20 6 0 0 0 0 9 12 17 0 0 0 8 14 16 5 14 21 21 6 0 0 0 0 2 10 7 
#Chair011
0 0 0 2 12 7 4 12 18 18 7 0 0 0 0 9 11 19 0 0 0 8 15 14 7 14 21 24 6 0 0 0 0 3 8 8 
#Chair010
0 0 0 2 11 7 5 11 18 18 7 0 0 0 0 9 11 19 0 0 0 8 15 14 7 14 20 25 7 0 0 0 0 3 8 8 
#Chair01
0 0 0 2 10 6 3 16 22 19 6 0 0 0 0 7 13 18 0 0 0 9 14 17 5 13 19 20 7 0 0 0 0 2 9 6 
#Bookshelf02
0 0 0 13 8 9 4 33 27 8 0 0 0 0 0 4 6 10 0 0 0 10 8 7 8 35 25 9 0 0 0 0 0 7 4 9 
#Bookshelf01
0 0 0 13 9 9 4 34 28 8 0 0 0 0 0 4 6 10 0 0 0 10 8 7 8 36 25 8 0 0 0 0 0 7 4 9 
