#TV
12 33 43 47 45 35 22 12 4 0 
#Desk
20 45 49 38 30 24 19 14 9 3 
#Chair09
11 32 52 61 52 31 8 2 1 0 
#Chair08
11 31 51 60 54 33 8 3 1 0 
#Chair07
11 32 50 59 52 33 9 3 1 0 
#Chair06
11 31 50 60 54 33 9 3 1 0 
#Chair05
11 31 51 60 53 33 9 3 1 0 
#Chair04
11 32 51 60 52 33 9 3 1 0 
#Chair03
11 32 51 60 53 32 9 3 1 0 
#Chair02
11 31 51 60 53 32 9 3 1 0 
#Chair010
11 31 51 60 52 33 9 3 1 0 
#Chair01
11 31 50 60 53 33 9 3 1 0 
