#TV
0 0 0 4 12 8 2 14 25 23 14 0 0 0 0 5 13 9 0 0 0 5 14 7 4 13 29 18 1 0 0 0 0 4 13 7 
#Desk
0 0 0 7 13 14 3 26 28 7 0 0 0 0 0 8 9 12 0 0 0 7 11 12 3 25 23 5 0 0 0 0 0 8 11 14 
#Chair09
0 0 0 0 0 2 3 16 29 29 8 1 0 0 0 7 18 11 0 0 0 5 16 12 3 17 28 28 8 1 0 0 0 0 0 1 
#Chair08
0 0 0 0 1 2 3 17 31 29 10 1 0 0 0 6 16 11 0 0 0 5 18 10 3 16 27 29 8 1 0 0 0 0 0 1 
#Chair07
0 0 0 0 1 1 4 14 29 27 8 1 0 0 0 5 18 11 0 0 0 8 19 12 3 15 26 28 9 1 0 0 0 0 0 2 
#Chair06
0 0 0 1 0 1 2 15 31 28 8 1 0 0 0 6 18 12 0 0 0 6 17 9 3 16 30 32 7 1 0 0 0 0 0 1 
#Chair05
0 0 0 1 1 2 4 13 27 27 7 1 0 0 0 8 15 13 0 0 0 6 19 12 4 17 30 28 7 1 0 0 0 0 1 1 
#Chair04
0 0 0 0 1 0 3 16 30 28 9 1 0 0 0 4 18 12 0 0 0 7 19 9 3 16 27 30 8 1 0 0 0 0 0 1 
#Chair03
0 0 0 0 0 2 4 15 29 28 9 1 0 0 0 6 15 11 0 0 0 5 20 12 2 18 29 29 8 1 0 0 0 1 0 1 
#Chair02
0 0 0 1 0 1 5 16 32 26 7 0 0 0 0 4 17 10 0 0 0 5 19 10 3 15 30 30 8 1 0 0 0 0 1 1 
#Chair010
0 0 0 1 1 2 4 17 28 30 9 2 0 0 0 6 18 10 0 0 0 6 17 11 2 14 29 27 8 0 0 0 0 1 0 2 
#Chair01
0 0 0 0 1 1 2 17 28 30 7 2 0 0 0 7 14 12 0 0 0 4 18 11 3 17 28 32 10 1 0 0 0 0 1 1 
