#TV
0 0 0 9 6 8 10 13 15 16 15 8 10 9 9 0 0 0 0 0 0 8 9 9 12 11 9 12 9 11 9 8 9 0 0 0 
#Desk
0 2 8 7 9 8 10 11 11 9 12 9 9 7 3 8 1 0 0 1 6 6 7 8 8 9 9 11 10 8 9 7 6 8 1 0 
#Chair09
0 0 0 1 0 1 2 10 17 21 25 11 15 9 7 4 0 0 0 1 4 7 10 10 11 24 19 20 11 1 1 1 0 0 0 0 
#Chair08
0 0 0 1 1 0 2 13 23 19 20 13 10 11 6 4 0 0 0 0 4 6 9 12 11 21 20 19 10 2 0 0 1 0 0 0 
#Chair07
0 0 0 1 1 1 2 10 20 21 20 11 11 11 7 4 0 0 0 0 5 7 10 16 11 22 17 19 12 2 1 0 1 0 0 0 
#Chair06
0 0 0 0 1 1 3 11 18 19 22 10 12 10 6 6 0 0 0 0 3 5 9 12 12 22 18 22 12 2 0 1 1 0 0 0 
#Chair05
0 0 0 2 0 1 2 11 19 16 22 10 12 10 7 5 0 0 0 1 4 8 11 14 11 21 20 20 12 3 0 1 0 0 0 0 
#Chair04
0 0 0 0 0 0 2 12 20 18 23 11 11 11 7 5 0 0 0 1 3 6 10 14 12 22 20 19 9 3 1 0 1 0 0 0 
#Chair03
0 0 0 1 0 1 3 11 19 19 21 11 11 9 7 5 0 0 0 0 5 6 13 10 10 22 19 21 13 2 1 0 0 0 0 0 
#Chair02
0 0 0 1 0 1 2 11 23 19 21 9 9 10 7 5 0 0 0 1 4 7 12 11 13 21 19 20 11 2 1 1 1 0 0 0 
#Chair010
0 0 0 1 0 1 2 9 22 20 26 11 12 10 7 4 0 0 0 0 5 7 10 12 10 22 19 19 9 1 1 1 1 0 0 0 
#Chair01
0 0 0 0 1 1 2 12 19 18 24 10 12 7 8 4 0 0 0 0 4 7 11 10 12 25 19 20 12 2 0 0 1 0 0 0 
