#Desk
0 0 0 2 1 1 2 4 5 8 6 6 5 6 6 6 7 7 6 11 18 18 16 18 20 13 11 10 6 5 4 5 3 2 2 1 
#Chair09
0 0 0 0 0 0 1 3 6 7 8 12 19 25 23 19 15 8 8 5 4 5 3 4 6 8 7 5 5 6 6 5 6 7 6 1 
#Chair08
0 0 0 0 0 0 1 2 4 8 8 11 22 25 21 20 16 10 6 7 6 4 4 5 6 6 8 7 4 6 6 6 5 6 3 2 
#Chair07
0 0 0 0 0 1 1 2 5 9 8 10 21 25 22 19 16 11 7 6 5 4 4 6 6 6 8 5 5 6 4 5 3 7 4 0 
#Chair06
0 0 0 0 0 1 1 2 4 5 6 12 22 28 20 19 17 12 7 6 4 4 4 4 6 8 7 5 7 5 6 6 5 6 4 0 
#Chair05
0 0 0 0 0 0 1 2 4 7 6 10 25 24 21 17 16 11 7 5 4 4 4 4 6 7 7 6 7 3 7 5 5 7 6 2 
#Chair04
0 0 0 0 0 0 1 1 4 8 8 9 24 24 21 22 15 9 7 6 5 4 4 5 5 7 7 6 5 5 5 6 7 6 3 1 
#Chair03
0 0 0 0 0 0 1 3 4 6 8 10 24 25 22 19 16 8 7 5 5 5 3 4 5 7 8 5 6 4 5 6 7 6 4 1 
#Chair02
0 0 0 0 0 0 2 3 3 7 11 11 22 21 20 18 17 12 7 4 5 4 3 3 6 8 7 7 6 5 4 6 7 5 4 0 
#Chair012
0 0 0 0 0 1 1 2 4 7 9 12 23 25 21 19 15 9 6 6 3 4 5 4 4 7 7 6 5 6 4 6 6 7 5 1 
#Chair011
0 0 0 0 0 1 1 2 5 6 7 11 22 27 22 21 16 10 8 4 4 4 5 3 8 6 7 5 5 5 4 6 6 7 4 1 
#Chair010
0 0 0 0 0 0 1 3 5 7 7 10 23 25 23 19 15 8 6 4 5 5 4 4 6 5 9 8 6 4 5 6 5 6 6 1 
#Chair01
0 0 0 0 0 0 1 2 4 6 7 11 23 28 21 18 14 10 8 5 4 6 4 3 5 7 8 7 4 5 5 6 6 7 5 1 
#CellingLight06
0 0 0 0 0 0 0 1 1 2 1 2 1 2 2 1 2 16 19 31 26 22 26 28 11 5 5 5 3 3 5 4 3 4 3 4 
#CellingLight05
0 0 0 0 0 0 0 1 1 2 1 2 1 1 1 1 2 16 19 31 26 21 26 28 11 5 5 5 4 3 6 4 3 4 4 4 
#CellingLight04
0 0 0 0 0 0 0 1 1 2 1 2 1 1 2 1 2 18 18 31 25 22 26 27 10 5 5 5 4 3 5 4 3 4 4 4 
#CellingLight03
0 0 0 0 0 0 0 1 1 2 1 2 1 2 2 1 2 16 19 32 26 22 26 28 10 5 5 5 4 3 5 4 3 4 4 4 
#CellingLight02
0 0 0 0 0 0 1 1 1 1 2 2 2 2 3 3 3 12 15 29 26 20 30 22 10 4 3 5 6 5 4 6 6 5 6 4 
#CellingLight01
0 0 0 0 0 0 1 1 1 1 2 2 2 2 3 3 3 12 16 30 25 21 30 22 10 4 3 5 6 4 4 6 6 5 6 4 
#Cabinet
0 0 0 0 0 0 0 1 2 6 9 9 8 9 6 7 7 6 7 7 6 16 16 12 7 9 8 13 18 12 8 9 10 6 4 1 
