#Desk
13 41 50 43 31 34 26 11 2 0 
#Chair09
14 40 56 60 42 25 9 5 2 0 
#Chair08
14 39 56 62 42 24 8 5 2 0 
#Chair07
15 41 57 61 41 23 8 4 1 0 
#Chair06
14 40 55 61 42 24 9 5 2 0 
#Chair05
14 39 55 60 42 25 9 5 2 0 
#Chair04
14 39 55 62 42 24 9 5 2 0 
#Chair03
14 41 57 60 41 23 8 4 2 0 
#Chair02
14 40 56 60 41 24 8 5 2 0 
#Chair012
14 40 56 60 41 24 9 4 2 0 
#Chair011
14 42 57 61 40 23 8 4 2 0 
#Chair010
14 39 56 61 41 24 9 5 2 0 
#Chair01
14 39 55 61 42 24 9 5 2 0 
#CellingLight06
5 20 38 52 58 51 19 7 1 0 
#CellingLight05
5 20 38 52 58 51 19 7 1 0 
#CellingLight04
5 20 38 52 58 51 19 7 1 0 
#CellingLight03
5 20 38 52 58 51 19 7 1 0 
#CellingLight02
5 20 38 51 56 49 21 9 2 0 
#CellingLight01
5 20 39 51 56 49 21 9 2 0 
#Cabinet
6 24 45 46 44 41 25 16 5 0 
