#Desk
0 0 0 4 7 5 4 20 30 20 2 0 0 0 0 4 14 10 0 0 0 6 14 9 5 19 32 21 3 0 0 0 0 4 8 4 
#Chair06
0 0 0 8 3 15 2 22 39 18 3 0 0 0 0 3 4 6 0 0 0 4 6 7 1 20 37 17 3 0 0 0 0 6 5 14 
#Chair05
0 0 0 7 5 15 1 20 35 20 4 0 0 0 0 4 6 8 0 0 0 4 6 5 2 22 38 19 2 0 0 0 0 6 4 14 
#Chair04
0 0 0 5 5 17 1 20 40 15 3 0 0 0 0 3 6 5 0 0 0 3 5 8 2 20 39 17 3 0 0 0 0 8 5 16 
#Chair03
0 0 0 6 5 14 3 23 37 17 5 0 0 0 0 4 6 5 0 0 0 4 5 6 1 19 41 17 2 0 0 0 0 6 4 14 
#Chair02
0 0 0 6 5 15 2 20 38 13 3 0 0 0 0 4 7 6 0 0 0 3 7 7 3 18 42 17 3 0 0 0 0 7 5 14 
#Chair01
0 0 0 6 4 13 2 20 38 16 4 0 0 0 0 4 7 8 0 0 0 3 5 7 2 19 39 18 2 0 0 0 0 6 4 17 
