#Desk
0 0 1 2 5 6 20 11 10 12 11 11 8 7 13 0 0 0 0 0 0 10 9 9 14 11 11 12 11 19 7 6 2 1 0 0 
#Chair06
0 0 1 5 5 15 3 6 29 17 15 12 4 3 2 3 0 0 0 1 3 4 4 5 13 15 16 27 5 3 13 6 4 1 0 0 
#Chair05
0 0 1 5 6 13 4 4 28 17 13 14 6 3 3 4 1 0 0 1 2 2 4 5 14 13 19 29 4 3 13 6 4 1 0 0 
#Chair04
0 0 2 5 6 13 3 4 25 18 16 12 5 3 3 2 0 0 0 1 3 4 4 4 13 16 17 28 4 2 16 6 4 2 0 0 
#Chair03
0 0 1 4 6 14 2 6 26 21 14 15 6 4 3 1 1 0 0 0 3 3 3 5 14 16 17 27 4 2 13 6 4 1 0 0 
#Chair02
0 0 2 4 6 13 4 3 25 16 16 11 5 5 2 3 1 0 0 0 3 4 5 4 12 16 20 28 4 3 13 8 4 0 0 0 
#Chair01
0 0 1 4 7 12 3 5 25 17 16 13 6 4 5 2 0 0 0 1 3 4 3 4 10 14 17 29 5 4 13 7 4 2 0 0 
