#Desk
0 0 1 2 2 3 5 6 7 5 7 8 6 10 9 12 11 12 12 10 9 9 10 9 7 9 6 8 9 8 9 8 4 2 3 1 
#Chair06
0 0 0 0 1 1 4 3 5 10 11 8 9 13 14 13 14 11 8 11 12 11 8 7 5 5 5 3 3 4 2 6 9 9 9 7 
#Chair05
0 0 0 0 1 1 2 5 5 9 11 8 10 13 14 17 9 9 9 11 11 11 9 8 6 6 6 3 4 2 2 4 9 10 8 7 
#Chair04
0 0 0 0 0 1 3 3 4 10 10 7 11 16 14 15 11 9 8 8 10 10 8 8 8 6 4 5 3 2 2 4 12 11 8 7 
#Chair03
0 0 0 1 1 1 3 4 6 10 9 7 11 14 17 15 12 9 7 7 12 10 9 8 7 8 4 5 3 2 3 4 9 8 9 4 
#Chair02
0 0 0 0 1 1 2 5 5 9 9 6 12 12 17 15 13 9 7 9 9 10 7 8 7 6 5 4 3 4 4 3 11 10 9 5 
#Chair01
0 0 0 0 1 2 4 3 6 10 8 7 13 10 13 15 12 11 8 10 12 10 8 5 7 6 5 3 4 3 3 5 11 10 9 6 
