#Desk
0 1 1 1 1 0 1 5 6 6 6 4 7 6 6 9 8 6 8 7 7 9 11 12 19 16 14 10 8 7 6 7 10 10 4 0 
#Chair08
0 0 0 0 1 1 1 2 3 7 11 15 19 22 20 16 20 13 9 9 7 5 5 6 4 4 3 3 3 3 4 4 6 7 7 2 
#Chair07
0 0 0 0 1 2 1 1 4 5 13 13 16 19 24 19 16 14 9 7 6 6 5 3 4 3 4 5 4 3 3 5 6 10 7 2 
#Chair06
0 0 0 0 1 1 1 2 4 6 11 14 17 22 23 14 16 16 9 9 6 9 4 4 4 3 3 5 2 4 4 5 6 8 5 2 
#Chair05
0 0 0 0 0 1 1 3 4 4 12 12 17 22 22 18 16 15 8 8 8 8 5 5 3 4 3 3 4 4 4 4 6 8 7 2 
#Chair04
0 0 0 0 1 1 1 2 4 6 12 12 18 21 20 15 16 15 11 8 9 6 6 4 5 2 5 4 3 4 2 4 6 7 8 2 
#Chair03
0 0 0 0 1 1 1 2 3 5 12 15 16 22 21 14 20 14 9 8 8 8 6 5 3 3 3 3 3 3 3 6 6 8 6 2 
#Chair02
0 0 0 0 0 1 2 2 3 6 10 16 17 18 21 15 16 16 9 8 9 8 6 5 5 4 4 3 5 2 4 3 5 8 5 3 
#Chair01
0 0 0 0 1 2 2 1 3 7 11 12 18 18 22 17 14 16 7 8 6 8 7 5 4 5 5 4 4 2 3 4 7 7 6 2 
