#Desk
11 28 42 51 47 34 26 10 3 0 
#Chair08
11 37 58 62 42 24 11 4 2 0 
#Chair07
11 36 57 61 43 25 12 5 2 0 
#Chair06
11 35 57 61 44 25 11 5 2 0 
#Chair05
11 36 57 61 44 25 11 5 2 0 
#Chair04
11 36 57 60 44 25 11 5 2 0 
#Chair03
11 36 57 61 44 25 11 5 2 0 
#Chair02
11 35 57 61 44 25 12 5 2 0 
#Chair01
11 35 57 60 44 25 11 5 2 0 
