#Desk
0 0 0 0 15 9 10 12 17 17 14 11 17 4 0 0 0 0 0 0 0 0 12 11 11 10 13 18 12 13 18 2 0 0 0 0 
#Chair08
0 0 0 1 2 7 7 18 25 17 13 8 6 6 3 3 1 0 0 0 5 5 4 5 9 14 17 25 19 6 8 5 1 1 0 0 
#Chair07
0 0 0 2 3 7 6 20 25 15 12 7 5 6 4 4 0 0 0 1 6 4 4 6 9 15 16 22 20 6 8 3 2 1 0 0 
#Chair06
0 0 0 2 3 9 7 18 25 19 12 7 5 5 5 4 0 0 0 0 4 5 4 5 8 13 19 23 19 5 10 2 2 1 0 0 
#Chair05
0 0 0 2 2 8 7 18 24 18 14 7 5 6 6 5 0 0 0 0 3 4 4 7 9 12 18 24 17 6 9 3 1 1 0 0 
#Chair04
0 0 1 2 2 8 8 17 27 18 13 8 6 5 5 4 1 0 0 1 5 3 6 6 8 13 17 23 18 6 8 3 2 0 0 0 
#Chair03
0 0 1 1 4 9 5 16 23 18 14 9 7 4 4 4 0 0 0 1 4 4 5 6 9 16 19 24 17 6 8 3 2 0 0 0 
#Chair02
0 0 0 3 1 10 6 20 22 17 14 10 7 6 4 4 1 0 0 0 3 4 5 6 7 13 14 22 21 8 7 3 1 0 0 0 
#Chair01
0 0 0 2 4 8 5 18 23 18 13 9 6 5 4 4 1 0 0 0 4 4 6 6 7 12 19 24 18 6 10 3 2 1 0 0 
