#Desk
0 0 0 4 11 10 4 16 22 19 20 0 0 0 0 3 9 8 0 0 0 4 10 9 2 14 21 22 18 1 0 0 0 3 7 9 
#Chair08
0 0 0 4 1 6 1 21 55 12 0 0 0 0 0 4 8 7 0 0 0 4 6 10 1 19 57 13 1 0 0 0 0 4 4 7 
#Chair07
0 0 0 3 4 5 1 19 54 11 0 0 0 0 0 4 8 9 0 0 0 4 6 11 2 20 56 11 0 0 0 0 0 3 4 8 
#Chair06
0 0 0 4 3 7 1 19 54 12 1 0 0 0 0 4 7 9 0 0 0 4 8 8 1 19 55 12 0 0 0 0 0 5 3 6 
#Chair05
0 0 0 4 2 8 1 19 57 12 0 0 0 0 0 4 9 10 0 0 0 6 7 6 1 19 53 13 0 0 0 0 0 5 3 7 
#Chair04
0 0 0 3 3 7 1 20 55 14 1 0 0 0 0 5 8 9 0 0 0 5 8 8 1 19 52 13 1 0 0 0 0 3 3 7 
#Chair03
0 0 0 5 3 8 1 20 51 13 0 0 0 0 0 5 7 8 0 0 0 4 7 9 1 19 57 13 0 0 0 0 0 4 3 6 
#Chair02
0 0 0 5 3 6 1 20 53 14 0 0 0 0 0 6 8 9 0 0 0 5 8 8 1 20 52 13 0 0 0 0 0 4 3 6 
#Chair01
0 0 0 4 4 6 1 20 51 13 1 0 0 0 0 5 7 9 0 0 0 5 9 8 2 18 56 11 0 0 0 0 0 6 3 7 
