#Desk
0 0 0 6 12 8 3 19 32 18 0 0 0 0 0 7 9 10 0 0 0 6 9 7 4 17 34 17 0 0 0 0 0 6 12 10 
#Chair06
0 0 0 4 4 9 4 23 36 20 2 0 0 0 0 4 8 6 0 0 0 5 7 6 4 23 34 22 3 1 0 0 0 5 4 8 
#Chair05
0 0 0 5 5 8 4 19 34 20 2 0 0 0 0 6 8 5 0 0 0 5 11 5 4 22 35 24 4 0 0 0 0 4 5 9 
#Chair04
0 0 0 6 4 8 5 24 33 16 3 0 0 0 0 4 7 7 0 0 0 5 9 7 4 23 36 19 4 0 0 0 0 5 4 11 
#Chair03
0 0 0 8 5 8 3 21 33 19 3 0 0 0 0 5 9 7 0 0 0 5 10 6 2 22 36 21 3 0 0 0 0 4 5 10 
#Chair02
0 0 0 5 4 7 5 21 32 19 3 0 0 0 0 6 7 5 0 0 0 5 9 7 4 24 34 23 3 0 0 0 0 5 6 9 
#Chair01
0 0 0 7 5 8 2 20 31 19 2 0 0 0 0 4 8 8 0 0 0 5 7 7 4 22 38 24 4 1 0 0 0 5 5 8 
