#TV03
12 34 45 47 43 33 21 13 4 0 
#TV02
13 34 45 48 44 33 20 11 3 0 
#TV01
13 36 47 50 43 29 18 11 4 0 
#Desk
19 46 44 46 34 20 18 18 7 0 
#Chair09
10 32 56 61 46 26 13 6 2 0 
#Chair08
10 34 56 62 46 24 12 6 2 0 
#Chair07
10 34 57 61 46 24 12 6 1 0 
#Chair06
10 35 58 63 45 23 11 5 1 0 
#Chair05
10 35 58 62 44 24 12 5 2 0 
#Chair04
10 35 57 61 45 24 12 6 2 0 
#Chair03
9 32 55 62 46 26 13 6 2 0 
#Chair02
9 32 56 62 47 26 12 6 2 0 
#Chair013
10 34 56 61 45 25 12 6 2 0 
#Chair012
10 33 56 61 45 25 12 6 2 0 
#Chair011
10 33 56 62 45 25 13 6 2 0 
#Chair010
10 32 55 61 46 26 13 6 2 0 
#Chair01
10 33 55 61 46 25 13 6 2 0 
#Cabinet05
9 35 45 46 43 36 23 11 2 0 
#Cabinet04
10 39 49 48 44 35 20 7 1 0 
#Cabinet03
11 40 48 48 44 34 19 7 1 0 
#Cabinet02
11 36 59 43 32 26 19 14 9 2 
#Cabinet01
10 35 58 43 33 25 20 14 10 3 
#Bookshelf06
6 28 51 53 42 32 21 13 4 0 
#Bookshelf05
6 24 46 50 42 38 24 16 6 0 
#Bookshelf04
6 25 48 53 44 38 22 12 4 0 
#Bookshelf03
6 24 45 50 43 40 24 14 5 0 
#Bookshelf02
6 25 46 53 44 37 24 14 3 0 
#Bookshelf01
6 24 46 53 44 38 24 13 3 0 
