#TV03
0 0 1 1 2 2 2 4 5 5 6 7 7 8 8 9 9 9 9 10 13 12 12 9 9 10 10 10 11 11 10 7 4 4 2 1 
#TV02
0 0 0 1 1 2 4 4 4 6 6 5 8 9 9 8 9 11 13 12 12 12 11 7 10 10 8 8 8 12 10 7 6 3 1 1 
#TV01
0 0 0 2 2 4 3 6 5 7 7 9 7 9 7 9 10 9 14 11 9 11 9 7 9 8 8 8 8 9 9 8 6 4 2 1 
#Desk
0 2 4 4 7 6 5 6 6 7 8 7 6 6 8 7 6 5 5 4 6 6 8 11 11 11 13 12 14 10 11 6 3 4 4 1 
#Chair09
0 0 0 0 0 1 1 1 2 5 11 14 15 16 20 14 19 10 13 7 8 8 10 9 6 4 4 4 3 3 4 2 5 8 5 7 
#Chair08
0 0 0 1 1 1 2 2 2 6 9 13 16 18 22 14 17 12 14 6 9 6 6 9 4 4 5 3 2 3 4 2 7 5 6 8 
#Chair07
0 0 0 1 1 2 2 1 2 6 9 14 17 17 22 17 14 10 13 8 8 8 8 8 4 5 5 4 5 3 3 2 6 6 5 5 
#Chair06
0 0 0 1 0 2 1 1 3 6 8 15 17 22 21 16 16 9 13 9 7 9 7 6 6 5 3 3 3 3 3 2 6 5 6 6 
#Chair05
0 0 0 1 1 2 2 1 3 6 10 15 17 17 19 18 18 10 12 7 6 8 7 8 7 4 3 3 4 3 3 2 5 5 6 7 
#Chair04
0 0 0 1 1 1 1 2 3 6 11 16 14 17 20 15 19 12 13 7 7 8 8 7 6 4 4 3 3 3 3 2 6 6 6 6 
#Chair03
0 0 0 0 1 1 1 1 2 6 9 14 14 19 19 14 18 12 11 7 7 8 9 8 8 6 4 3 2 3 3 3 6 7 6 7 
#Chair02
0 0 0 0 1 1 1 1 2 6 9 14 14 19 20 14 18 12 12 7 6 8 9 8 8 6 4 3 2 3 3 2 5 7 6 6 
#Chair013
0 0 0 1 1 1 1 1 3 5 9 14 18 18 20 16 18 8 13 7 6 8 11 8 6 4 2 3 3 3 3 2 8 6 5 6 
#Chair012
0 0 0 1 0 0 1 2 3 9 9 14 15 18 20 16 16 10 12 5 9 9 9 8 5 5 4 3 3 3 3 3 5 6 6 7 
#Chair011
0 0 0 0 0 2 0 2 2 6 10 13 15 18 20 18 17 10 12 8 6 7 8 6 6 5 5 3 3 3 4 3 6 7 4 7 
#Chair010
0 0 0 0 0 1 0 2 3 7 9 16 14 16 21 15 15 11 14 8 5 9 8 6 5 5 4 4 5 2 3 3 6 7 7 7 
#Chair01
0 0 0 1 1 1 0 1 2 5 10 15 19 18 20 14 19 9 11 7 9 8 8 5 6 4 4 3 3 3 4 4 7 7 6 6 
#Cabinet05
0 0 0 0 0 0 1 2 2 1 4 7 6 6 7 6 11 12 11 9 10 12 15 14 11 11 9 13 16 11 7 8 6 5 4 1 
#Cabinet04
0 0 0 0 0 0 1 1 3 3 5 6 8 6 7 9 12 11 10 11 12 11 18 17 11 13 13 11 10 8 7 7 3 3 2 0 
#Cabinet03
0 0 0 0 0 0 0 2 2 5 7 5 6 6 8 12 13 11 10 12 13 18 15 13 12 11 12 11 9 9 7 5 3 3 2 0 
#Cabinet02
0 0 0 0 0 1 1 1 3 7 14 13 13 12 10 9 7 7 8 8 5 7 8 10 8 6 6 7 5 7 6 10 14 19 7 1 
#Cabinet01
0 0 0 0 1 1 1 2 7 6 10 12 12 9 11 9 10 7 9 6 8 6 7 6 6 7 8 6 6 6 7 11 16 19 8 1 
#Bookshelf06
0 0 1 1 2 1 2 4 5 6 8 6 7 7 7 7 7 8 9 12 12 14 11 8 11 7 10 8 11 14 11 7 7 5 2 1 
#Bookshelf05
0 0 0 0 1 0 2 2 4 6 6 5 6 5 8 6 7 6 8 12 14 15 10 9 9 8 10 8 12 14 14 11 10 6 2 1 
#Bookshelf04
0 0 0 1 1 1 4 3 5 6 5 6 6 7 5 7 8 7 11 11 13 16 13 10 10 8 8 8 11 12 10 7 8 5 5 0 
#Bookshelf03
0 0 0 0 1 1 2 2 4 5 4 6 5 6 6 6 7 6 10 12 16 15 12 10 8 11 11 7 14 16 12 9 8 5 4 0 
#Bookshelf02
0 0 0 1 1 1 3 4 4 5 5 6 8 6 6 6 6 8 8 9 14 13 11 11 9 10 9 10 17 13 9 6 7 5 4 1 
#Bookshelf01
0 0 0 0 1 1 1 3 3 7 6 7 6 6 6 8 7 6 6 9 16 13 14 12 9 10 8 12 16 10 8 8 8 5 4 1 
