#WaterFountain
14 46 64 44 31 23 15 8 5 2 
#Screen02
13 28 37 42 44 34 23 17 11 1 
#Screen01
14 28 37 41 44 33 24 17 12 1 
#Desk
16 53 60 43 31 23 16 8 2 0 
#Chair09
10 23 41 53 54 33 20 13 5 0 
#Chair08
10 23 41 53 54 33 20 13 5 0 
#Chair07
10 23 40 53 53 32 20 13 5 1 
#Chair06
10 23 41 51 52 32 21 14 6 1 
#Chair05
10 23 40 52 52 31 21 14 6 1 
#Chair04
10 23 40 52 52 32 21 14 6 1 
#Chair03
10 23 40 52 52 32 21 14 6 1 
#Chair02
10 23 40 52 53 32 20 14 6 1 
#Chair012
10 24 41 53 53 32 20 13 5 0 
#Chair011
10 24 41 53 53 32 20 13 5 0 
#Chair010
10 23 41 53 53 31 20 14 6 1 
#Chair01
10 23 40 53 54 33 20 13 5 0 
#CellingLight03
5 20 34 42 43 39 32 22 12 2 
#CellingLight02
5 19 33 42 43 39 32 23 13 2 
#CellingLight01
36 43 31 32 40 17 14 13 20 3 
#Cabinet
8 25 46 56 40 29 21 15 9 2 
#Bonsai03
3 13 26 37 45 45 42 29 12 0 
#Bonsai02
8 31 46 53 41 29 21 15 6 1 
#Bonsai01
4 16 30 37 43 47 48 20 6 1 
