#WaterFountain
2 5 3 4 6 5 6 17 17 19 18 15 8 5 5 3 1 0 0 1 5 5 7 7 8 10 10 11 14 6 5 3 3 1 2 3 
#Screen02
0 0 0 16 8 7 10 11 10 11 10 10 8 8 15 0 0 0 0 0 0 17 8 10 10 11 9 10 9 9 7 7 13 0 0 0 
#Screen01
0 0 0 16 9 9 9 9 11 10 8 8 8 5 16 0 0 0 0 0 0 16 8 9 11 11 10 10 9 10 8 8 15 0 0 0 
#Desk
0 0 1 2 8 9 14 8 17 14 9 13 10 8 4 2 0 0 0 1 3 2 9 11 13 6 15 14 10 13 10 8 4 2 0 0 
#Chair09
0 0 1 6 11 20 8 1 15 27 3 8 7 7 4 3 0 0 0 0 3 3 6 7 7 3 28 16 1 6 23 8 5 1 1 0 
#Chair08
0 0 1 6 11 20 8 1 16 26 3 8 7 7 4 3 0 0 0 0 3 3 6 7 7 3 28 17 1 6 23 8 5 2 1 0 
#Chair07
0 1 1 6 12 20 6 2 16 27 3 6 9 7 4 3 0 0 0 0 2 5 7 7 7 2 27 15 3 5 22 11 6 1 0 0 
#Chair06
0 0 1 7 11 22 5 2 12 24 4 6 9 8 4 3 0 0 0 0 4 4 7 6 7 2 28 15 2 7 22 10 8 2 0 0 
#Chair05
0 1 2 6 12 22 5 3 14 26 3 8 9 7 4 3 0 0 0 0 2 4 7 8 4 3 26 14 2 6 22 11 7 2 1 0 
#Chair04
0 1 2 6 12 22 5 2 14 26 4 7 8 7 4 3 0 0 0 0 2 4 7 8 4 3 26 13 2 5 22 11 7 2 1 0 
#Chair03
0 1 1 6 9 20 5 2 14 26 1 6 8 8 4 3 0 0 0 0 3 3 9 9 6 3 28 15 2 7 22 11 7 1 1 0 
#Chair02
0 1 1 7 9 19 5 2 14 26 1 6 8 8 4 3 0 0 0 0 3 3 9 8 6 2 29 14 2 7 21 10 7 1 1 0 
#Chair012
0 0 2 5 12 22 7 3 16 24 2 6 6 6 3 2 0 0 0 0 2 4 8 7 8 2 27 15 3 8 20 11 6 2 1 0 
#Chair011
0 0 1 5 11 22 6 3 17 25 3 6 6 6 4 2 0 0 0 0 2 5 8 7 8 2 26 15 3 7 21 11 5 2 1 0 
#Chair010
0 0 1 6 10 23 6 3 14 28 3 5 7 9 3 3 0 0 0 0 4 3 7 8 5 3 28 12 2 5 23 11 6 2 0 0 
#Chair01
0 0 1 6 13 23 4 3 18 27 3 7 7 6 3 3 0 0 0 0 3 4 7 7 6 2 25 14 2 6 24 10 7 0 0 0 
#CellingLight03
0 2 2 5 7 10 11 15 14 12 12 11 9 9 4 1 0 0 0 1 1 4 5 11 11 12 12 15 11 11 8 6 7 1 1 0 
#CellingLight02
0 0 2 5 7 9 9 14 12 14 12 9 7 9 6 1 0 0 0 0 2 5 8 11 11 13 13 14 14 13 9 6 4 1 0 0 
#CellingLight01
0 0 13 29 5 3 5 5 23 22 6 5 5 6 28 12 1 0 1 2 2 3 4 5 8 7 4 6 6 5 5 4 3 2 1 1 
#Cabinet
0 0 8 7 6 9 9 8 10 9 9 8 7 5 9 6 0 0 0 0 9 6 7 10 10 12 13 11 11 12 11 7 5 9 0 0 
#Bonsai03
0 0 0 1 3 9 17 20 22 16 13 8 9 5 5 5 2 0 0 1 4 4 6 6 9 13 11 15 12 12 7 3 3 0 0 0 
#Bonsai02
0 0 5 10 11 15 15 8 10 7 9 7 8 5 4 1 3 0 0 3 1 3 6 7 6 7 9 13 10 20 15 10 8 5 0 0 
#Bonsai01
0 0 1 4 7 9 17 23 9 11 10 7 6 5 4 5 1 0 0 2 5 3 7 8 8 8 11 8 25 15 12 5 3 3 0 0 
