#Screen
0 0 0 1 11 10 11 14 13 13 10 14 12 10 2 0 0 0 0 0 0 1 9 13 11 12 14 15 12 13 10 11 2 0 0 0 
#Projector
0 0 0 0 7 10 5 2 12 30 23 20 23 15 5 0 0 0 0 0 2 7 11 11 17 19 7 0 0 0 2 10 6 0 0 0 
#Picture
0 0 0 0 11 11 10 13 12 17 14 10 12 12 0 0 0 0 0 0 0 0 12 10 12 12 13 14 14 11 11 14 0 0 0 0 
#Notebook
0 0 0 0 6 17 13 13 12 11 15 15 12 8 0 0 0 0 0 0 0 1 10 12 14 14 10 13 16 14 13 5 0 0 0 0 
#Desk
0 1 2 4 6 6 18 10 10 11 11 25 6 6 3 2 1 0 0 1 3 4 3 8 17 8 11 9 10 23 7 6 4 3 1 0 
#Clock
0 1 2 5 8 10 8 12 16 13 12 10 9 7 4 4 1 0 0 1 3 6 8 9 9 11 13 14 11 11 6 7 6 3 0 0 
#Chair09
0 0 2 4 8 6 6 8 31 13 2 3 20 11 7 2 0 0 0 0 2 4 11 21 3 1 14 29 7 7 8 6 4 2 0 0 
#Chair08
0 0 2 4 9 6 6 8 31 13 2 3 20 11 7 2 0 0 0 0 2 4 11 21 3 1 14 28 7 7 9 6 4 3 0 0 
#Chair07
0 0 3 4 6 7 8 7 31 13 3 4 18 8 5 1 0 0 0 1 1 7 9 21 3 2 14 32 8 8 7 5 3 3 0 0 
#Chair06
0 0 3 4 6 7 8 7 31 13 3 3 18 9 5 1 0 0 0 1 1 7 10 20 3 2 14 33 8 8 7 6 3 3 0 0 
#Chair05
0 0 3 4 6 7 9 7 30 13 3 3 18 9 5 1 0 0 0 1 1 7 10 21 3 2 14 32 8 7 7 6 2 3 0 0 
#Chair04
0 0 2 3 8 7 8 6 27 16 2 2 19 14 5 1 0 0 0 0 2 5 11 19 3 2 15 32 9 6 7 6 3 2 0 0 
#Chair03
0 0 2 3 7 7 8 6 27 17 2 2 19 13 5 1 0 0 0 0 2 5 11 19 2 2 16 32 9 6 7 6 3 2 0 0 
#Chair02
0 0 2 3 8 7 8 6 27 16 2 2 19 14 5 1 0 0 0 0 2 5 12 19 2 2 15 32 9 6 7 6 3 2 0 0 
#Chair016
0 0 3 3 5 7 7 7 34 14 2 4 20 10 6 1 0 0 0 0 1 5 12 20 2 1 15 27 8 4 8 7 2 3 0 0 
#Chair015
0 0 3 3 5 7 8 7 34 15 2 4 19 11 6 1 0 0 0 0 1 6 12 20 2 1 15 27 8 4 8 8 2 3 0 0 
#Chair014
0 0 3 3 5 7 8 7 34 14 2 4 20 10 6 1 0 0 0 0 1 5 12 20 2 1 14 27 8 4 8 8 2 3 0 0 
#Chair013
0 0 1 5 4 7 10 7 35 14 2 3 21 10 6 1 0 0 0 0 0 6 9 18 4 2 10 30 8 8 6 7 4 2 0 0 
#Chair012
0 0 1 5 4 7 9 8 34 14 2 3 20 10 6 1 0 0 0 0 0 6 10 18 4 2 10 31 8 7 6 6 4 2 0 0 
#Chair011
0 0 1 5 3 7 10 7 35 14 2 4 21 10 5 1 0 0 0 0 0 6 10 18 4 2 11 30 8 7 6 7 4 2 0 0 
#Chair010
0 0 4 3 7 8 7 8 30 16 3 3 19 11 5 1 0 0 0 0 1 5 11 19 3 1 14 28 7 7 8 6 4 2 0 0 
#Chair01
0 0 4 4 7 8 7 8 31 16 3 3 20 10 5 1 0 0 0 0 1 4 10 19 3 1 14 28 7 7 8 7 4 2 0 0 
#CellingLight09
0 0 8 12 16 16 18 22 22 25 25 22 20 21 12 5 0 0 0 0 0 1 0 0 0 0 0 0 0 0 0 0 2 0 0 0 
#CellingLight08
0 0 0 0 22 8 8 9 10 18 11 11 7 17 0 0 0 0 0 0 0 0 19 9 8 11 8 20 12 9 12 17 0 0 0 0 
#CellingLight07
0 0 0 0 18 6 10 9 17 11 11 9 8 19 0 0 0 0 0 0 0 0 17 9 10 10 19 14 11 11 8 19 0 0 0 0 
#CellingLight06
0 0 0 0 18 6 9 9 9 18 10 9 8 19 0 0 0 0 0 0 0 0 17 8 9 11 10 24 11 11 8 19 0 0 0 0 
#CellingLight05
0 0 0 0 18 6 10 9 16 12 11 9 8 19 0 0 0 0 0 0 0 0 17 8 10 10 19 14 11 10 8 19 0 0 0 0 
#CellingLight04
0 0 0 0 18 6 9 9 10 17 10 9 8 19 0 0 0 0 0 0 0 0 17 8 9 10 9 24 11 11 8 20 0 0 0 0 
#CellingLight03
0 0 0 0 18 9 12 9 20 11 10 12 9 18 0 0 0 0 0 0 0 0 18 9 9 10 15 12 9 10 9 18 0 0 0 0 
#CellingLight02
0 0 0 0 18 9 12 9 12 20 10 11 9 18 0 0 0 0 0 0 0 0 18 9 9 10 10 18 9 11 9 18 0 0 0 0 
#CellingLight012
0 0 5 14 17 18 19 21 23 21 25 24 22 18 14 5 0 0 0 0 0 1 0 0 0 0 0 0 0 0 0 0 1 0 0 0 
#CellingLight011
0 0 6 14 17 17 19 22 23 22 25 23 22 18 15 5 0 0 0 0 0 1 0 0 0 0 0 0 0 0 0 0 1 0 0 0 
#CellingLight010
0 0 4 16 17 19 22 22 23 23 21 23 20 16 16 5 0 0 0 0 0 1 0 0 0 0 0 0 0 0 0 0 2 0 0 0 
#CellingLight01
0 0 0 0 19 8 11 9 16 9 10 10 9 21 0 0 0 0 0 0 0 0 22 6 8 11 19 11 9 12 8 20 0 0 0 0 
#Cabinet
0 0 9 5 5 7 6 7 8 10 8 7 7 5 5 9 0 0 0 0 9 8 10 10 10 11 15 14 12 11 10 8 6 9 0 0 
#Book
0 0 0 0 21 16 12 10 13 13 11 17 10 13 0 0 0 0 0 0 0 0 10 8 10 9 11 10 11 9 12 20 0 0 0 0 
#Ashtray
0 1 3 4 8 11 11 12 13 13 11 13 10 8 5 1 1 0 0 1 1 5 7 9 12 9 10 12 12 11 11 8 4 3 0 0 
