#Screen
0 0 1 1 2 4 3 5 4 6 5 7 7 8 8 9 8 12 11 13 13 13 14 11 11 11 10 11 9 7 6 3 4 2 1 0 
#Projector
0 0 0 0 0 0 1 1 1 2 2 2 1 3 3 3 2 3 5 7 9 8 13 15 16 19 19 22 21 18 15 13 9 5 2 1 
#Picture
0 2 1 1 2 2 3 5 3 4 5 6 7 8 7 8 9 9 10 10 12 12 13 14 16 12 11 12 8 7 7 5 4 1 1 1 
#Notebook
0 0 0 0 0 0 0 0 0 0 0 0 0 0 7 11 13 18 16 19 18 18 16 20 16 17 15 14 11 6 4 2 2 2 0 0 
#Desk
0 1 1 4 4 6 7 11 10 9 9 7 7 8 9 9 10 18 20 14 10 6 5 5 5 3 5 5 4 4 4 4 3 5 4 2 
#Clock
0 0 0 2 2 4 5 7 2 2 4 3 3 3 3 4 4 4 4 4 4 6 5 6 6 9 7 6 7 6 21 17 17 18 16 28 
#Chair09
0 1 1 1 2 2 2 4 4 3 5 4 5 5 7 7 7 9 8 9 11 11 9 11 14 12 11 8 7 8 10 9 9 10 8 7 
#Chair08
0 1 1 1 1 2 2 4 4 3 4 5 5 6 7 7 7 9 7 9 11 11 9 10 14 12 10 8 7 8 10 9 9 10 8 7 
#Chair07
0 1 1 1 1 2 4 4 4 6 4 5 5 5 7 8 6 8 12 9 12 10 9 12 14 10 10 8 6 7 8 6 8 9 10 7 
#Chair06
0 1 1 1 2 2 4 4 4 6 3 5 4 5 7 8 7 8 12 9 12 10 9 12 14 10 10 8 6 7 7 6 8 10 10 7 
#Chair05
0 1 1 1 2 2 4 4 4 6 4 4 4 5 6 8 6 8 11 9 12 10 9 12 14 10 10 8 6 7 8 6 8 10 10 7 
#Chair04
0 0 1 2 2 3 2 3 3 3 5 6 6 6 7 7 7 7 11 7 11 9 11 11 14 12 12 9 8 7 8 8 8 9 7 5 
#Chair03
0 1 1 2 2 3 3 3 3 4 5 6 6 6 7 7 7 7 12 7 11 10 10 11 14 12 12 9 8 7 8 7 8 9 7 5 
#Chair02
0 0 1 2 2 3 2 3 4 3 5 6 6 6 6 7 7 8 11 7 11 9 11 11 14 12 12 9 8 8 8 8 7 9 8 5 
#Chair016
0 1 1 1 1 3 3 3 4 5 4 8 4 6 7 8 8 6 10 9 8 10 10 12 13 12 10 9 7 8 8 8 8 9 9 7 
#Chair015
0 1 1 1 1 3 3 3 4 5 4 7 4 6 7 8 8 7 10 9 9 10 10 12 13 12 10 8 7 8 8 8 9 8 9 6 
#Chair014
0 1 1 1 1 3 3 3 4 5 4 8 4 6 7 8 7 7 10 9 8 10 10 12 13 12 10 9 7 8 8 7 8 9 9 7 
#Chair013
0 2 0 1 2 2 3 4 4 4 4 7 5 5 6 7 7 10 9 9 11 11 11 12 14 13 9 8 5 9 8 9 6 9 9 4 
#Chair012
0 2 0 1 2 2 4 3 5 3 4 8 4 5 6 6 7 9 9 10 10 12 11 12 14 13 8 8 5 9 8 9 6 9 8 4 
#Chair011
0 2 0 1 2 2 3 4 4 4 4 7 5 5 6 7 7 10 9 9 10 11 11 11 14 13 8 8 5 9 8 9 6 10 9 4 
#Chair010
0 1 1 1 2 3 3 3 3 4 4 7 6 5 8 7 6 8 9 8 11 9 13 12 12 12 12 9 8 8 7 6 7 8 8 7 
#Chair01
0 1 1 2 2 3 3 2 3 4 5 7 7 6 8 6 7 8 10 8 11 9 13 12 12 12 12 9 8 8 7 7 7 8 7 7 
#CellingLight09
0 0 0 0 0 0 0 0 0 0 0 0 0 0 0 1 38 19 17 15 11 8 11 9 9 10 9 7 10 11 9 11 9 6 8 15 
#CellingLight08
0 0 0 0 1 0 2 2 4 5 4 5 3 4 3 6 6 5 6 5 5 6 5 12 20 30 19 14 11 12 12 8 10 8 6 2 
#CellingLight07
0 0 0 0 0 1 2 2 4 6 5 5 4 4 3 6 6 5 4 4 6 6 6 14 16 29 21 15 12 10 11 11 5 9 3 3 
#CellingLight06
0 0 0 0 1 1 2 3 4 6 5 5 5 4 3 6 6 5 4 4 6 6 6 13 16 30 21 14 12 10 11 12 5 9 3 3 
#CellingLight05
0 0 0 0 0 1 2 2 4 6 6 5 5 4 3 6 6 5 4 4 6 5 6 14 16 29 21 15 12 10 11 11 6 9 3 3 
#CellingLight04
0 0 0 0 0 1 2 3 4 6 5 5 5 4 3 6 6 5 4 4 6 6 6 13 15 30 21 15 12 10 11 11 5 9 3 3 
#CellingLight03
0 0 0 0 1 1 1 3 4 5 3 4 4 4 5 4 6 4 6 6 5 4 6 15 17 31 19 16 13 11 11 9 9 6 4 2 
#CellingLight02
0 0 0 0 1 1 1 3 4 4 3 4 3 4 5 5 6 4 6 5 5 4 6 14 18 31 19 17 13 11 11 9 9 6 5 1 
#CellingLight012
0 0 0 0 0 0 0 0 0 0 0 0 0 0 0 1 36 19 16 14 12 11 12 8 10 10 9 10 7 10 12 11 9 8 8 11 
#CellingLight011
0 0 0 0 0 0 0 0 0 0 0 0 0 0 0 1 36 19 16 14 12 11 12 8 9 10 9 10 7 10 12 11 9 8 9 12 
#CellingLight010
0 0 0 0 0 0 0 0 0 0 0 0 0 0 0 1 36 22 14 12 13 10 11 11 12 10 8 8 8 9 9 12 9 11 9 12 
#CellingLight01
0 0 0 1 0 1 1 1 4 6 5 4 4 4 5 4 5 5 5 5 5 6 4 10 18 31 17 16 16 11 12 9 9 8 5 2 
#Cabinet
0 1 1 2 2 3 4 5 7 9 8 11 10 9 8 10 7 7 6 9 6 8 7 7 7 8 7 5 5 6 7 8 7 18 13 3 
#Book
0 0 0 0 1 1 2 2 2 2 3 2 3 4 6 6 6 7 9 10 13 14 16 14 16 15 19 18 17 13 8 6 3 2 1 0 
#Ashtray
0 0 0 0 0 0 0 0 1 2 2 2 2 2 3 2 4 4 10 9 8 8 10 11 9 13 12 12 13 13 14 15 18 14 21 6 
