#Desk
0 0 1 2 3 8 19 13 9 12 15 21 8 4 3 1 0 0 0 1 2 3 6 6 19 12 12 10 11 21 9 4 3 2 0 0 
#Chair09
0 0 0 3 4 7 3 5 18 24 18 16 9 6 5 4 0 0 0 0 3 4 6 6 15 19 23 22 4 2 5 6 2 0 0 0 
#Chair08
0 0 1 3 5 6 1 4 21 25 19 15 9 5 5 3 0 0 0 0 2 5 4 7 14 17 27 23 5 2 6 5 4 1 0 0 
#Chair07
0 0 0 3 5 6 2 3 23 26 17 14 6 6 5 2 1 0 0 1 4 6 5 8 17 15 23 22 6 2 7 5 2 0 0 0 
#Chair06
0 0 0 3 4 6 2 3 23 26 18 14 6 6 5 2 1 0 0 1 4 6 5 8 17 14 24 22 7 2 7 5 2 0 0 0 
#Chair05
0 0 0 3 5 5 3 4 19 23 19 16 8 6 4 3 0 0 0 0 3 5 7 7 15 18 24 24 6 1 5 4 3 0 0 0 
#Chair04
0 0 0 3 4 7 2 5 23 24 18 15 7 7 5 3 0 0 0 0 4 3 5 8 17 18 22 21 6 1 4 4 3 1 0 0 
#Chair03
0 0 0 3 4 5 2 5 21 23 18 17 7 6 4 3 1 0 0 0 3 5 6 6 14 15 25 25 6 1 6 5 4 0 0 0 
#Chair02
0 0 0 3 3 6 1 5 18 22 18 15 7 6 5 3 1 0 0 1 3 5 7 11 14 17 25 24 5 2 6 5 3 0 0 0 
#Chair012
0 0 0 3 5 5 2 5 23 27 15 14 7 6 4 4 0 0 0 0 4 4 6 7 17 16 25 21 5 2 6 5 3 0 0 0 
#Chair011
0 0 0 3 6 7 2 5 19 20 20 15 9 8 5 3 0 0 0 1 3 5 7 6 15 18 25 21 5 2 5 3 4 0 0 0 
#Chair010
0 0 0 3 6 5 2 5 23 26 16 15 8 4 5 3 1 0 0 0 4 6 5 7 15 16 25 21 4 1 5 7 3 0 0 0 
#Chair01
0 0 0 3 5 7 1 5 22 26 20 15 7 6 5 2 1 0 0 1 3 3 7 7 17 16 22 22 5 1 5 4 3 1 0 0 
#CellPhone
0 0 8 6 6 7 10 10 10 12 10 10 8 6 7 9 0 0 0 0 8 6 9 7 10 10 11 12 10 9 8 9 7 7 0 0 
#Book03
0 0 0 2 7 9 12 11 14 15 13 14 8 9 3 0 0 0 0 0 0 4 12 11 10 12 14 14 11 11 12 10 4 0 0 0 
#Book02
0 0 0 5 11 10 12 13 13 10 14 12 11 9 4 0 0 0 0 0 0 4 7 13 11 12 13 13 12 11 11 9 4 0 0 0 
#Book01
0 0 0 4 10 11 12 14 10 13 13 12 10 10 5 0 0 0 0 0 0 4 9 11 12 12 14 12 12 11 12 7 4 0 0 0 
