#Desk
0 1 2 2 3 5 5 6 6 7 8 7 9 11 10 14 15 12 12 14 13 14 10 9 7 6 4 3 3 4 3 3 3 3 1 1 
#Chair09
0 0 0 1 3 4 3 6 5 4 6 6 8 14 13 16 13 13 13 11 9 11 10 8 7 3 4 4 3 4 4 8 10 8 5 3 
#Chair08
0 0 0 1 3 3 3 4 4 7 8 8 7 11 17 14 13 13 13 11 9 10 10 8 6 5 2 2 3 3 5 8 9 7 7 3 
#Chair07
0 0 0 1 2 3 4 4 5 5 6 6 6 12 16 15 15 14 13 11 10 11 9 8 5 5 4 2 3 3 7 8 9 8 5 4 
#Chair06
0 0 0 1 2 3 4 4 5 6 6 6 7 12 16 15 16 14 13 11 10 10 9 8 5 4 4 2 3 3 6 8 9 8 5 4 
#Chair05
0 0 1 2 2 4 4 4 5 3 6 6 7 14 15 15 13 14 13 11 13 9 12 9 4 4 4 3 3 3 3 8 11 6 6 2 
#Chair04
0 0 1 2 2 3 5 4 5 6 6 6 6 11 15 17 17 15 13 11 10 10 10 6 5 3 2 3 2 4 5 7 10 8 7 3 
#Chair03
0 0 0 2 3 3 3 3 6 5 5 7 8 14 14 14 17 14 12 11 10 10 10 8 5 4 2 3 3 3 4 8 8 8 7 3 
#Chair02
0 0 0 1 2 4 3 4 5 4 6 7 8 13 13 14 14 14 11 11 11 9 10 10 7 6 4 3 4 3 4 6 10 8 6 3 
#Chair012
0 0 1 1 2 4 3 5 4 7 5 6 8 13 15 16 15 16 12 9 10 11 9 8 4 3 4 2 3 2 4 8 10 6 7 3 
#Chair011
0 0 1 1 1 2 3 4 6 4 7 5 7 13 14 14 13 15 13 12 11 12 11 9 5 6 4 4 2 3 6 7 10 8 7 2 
#Chair010
0 0 1 2 2 2 5 5 5 6 7 5 6 11 15 15 14 16 14 10 9 11 9 7 5 3 3 3 3 5 6 8 11 7 5 3 
#Chair01
0 0 0 2 2 2 3 4 4 5 7 5 6 14 14 16 15 15 13 9 11 13 10 8 5 4 3 3 3 3 4 9 8 6 7 3 
#CellPhone
0 0 0 1 2 2 3 3 4 4 5 6 6 8 10 8 9 12 12 9 8 8 8 8 8 7 6 7 9 9 7 8 8 14 11 10 
#Book03
0 0 2 2 2 4 4 4 5 4 7 8 7 7 8 9 9 10 13 13 12 11 13 9 9 11 10 10 10 8 5 5 3 2 1 0 
#Book02
0 0 1 1 2 3 3 5 5 6 6 8 7 8 9 9 11 14 10 11 11 11 12 13 10 10 8 9 9 8 6 4 3 3 2 0 
#Book01
0 0 0 2 3 3 3 4 5 6 6 8 7 7 9 9 12 13 10 11 12 10 12 12 10 10 8 9 9 9 7 4 3 3 2 1 
