#Desk
0 0 0 6 6 3 7 21 38 25 0 0 0 0 0 8 5 4 0 0 0 5 9 5 8 20 36 22 0 0 0 0 0 7 8 3 
#Chair09
0 0 0 0 1 13 4 17 40 22 1 0 0 0 0 7 11 8 0 0 0 6 9 7 5 15 40 25 1 0 0 0 0 0 2 11 
#Chair08
0 0 0 0 2 13 4 17 40 23 1 0 0 0 0 8 8 7 0 0 0 6 8 5 5 20 38 25 1 0 0 0 0 0 2 14 
#Chair07
0 0 0 1 2 12 3 17 41 24 0 0 0 0 0 5 8 7 0 0 0 8 7 9 4 15 39 24 2 0 0 0 0 0 2 13 
#Chair06
0 0 0 0 1 12 3 18 42 23 0 0 0 0 0 5 9 7 0 0 0 8 7 9 4 15 39 25 1 0 0 0 0 0 2 12 
#Chair05
0 0 0 1 2 12 5 13 41 24 0 0 0 0 0 7 9 6 0 0 0 7 9 7 5 17 39 27 1 0 0 0 0 0 1 11 
#Chair04
0 0 0 1 1 13 4 17 44 22 1 0 0 0 0 7 8 9 0 0 0 8 7 7 4 16 39 24 1 0 0 0 0 0 1 11 
#Chair03
0 0 0 0 1 11 4 16 41 24 1 0 0 0 0 7 9 7 0 0 0 5 9 7 5 16 41 24 1 0 0 0 0 0 1 15 
#Chair02
0 0 0 0 2 11 4 13 40 22 1 0 0 0 0 7 9 8 0 0 0 10 11 7 4 18 38 25 2 0 0 0 0 0 2 13 
#Chair012
0 0 0 0 1 12 5 17 43 21 0 0 0 0 0 6 8 7 0 0 0 6 8 8 5 15 42 25 1 0 0 0 0 1 1 13 
#Chair011
0 0 0 1 3 13 3 14 39 24 0 0 0 0 0 9 10 8 0 0 0 6 8 8 3 16 38 28 1 0 0 0 0 0 1 11 
#Chair010
0 0 0 0 1 13 5 18 41 23 0 0 0 0 0 7 8 7 0 0 0 7 8 9 3 17 38 22 2 0 0 0 0 0 3 12 
#Chair01
0 0 0 0 3 13 4 16 44 26 0 0 0 0 0 8 7 8 0 0 0 7 8 6 3 15 38 24 2 0 0 0 0 0 2 12 
#CellPhone
0 0 0 5 8 15 2 13 28 18 1 0 0 0 0 4 11 16 0 0 0 4 11 15 3 13 26 18 1 0 0 0 0 4 13 14 
#Book03
0 0 0 5 11 4 8 17 28 23 4 0 0 0 0 5 11 4 0 0 0 6 17 4 6 16 24 25 2 0 0 0 0 7 15 5 
#Book02
0 0 0 6 13 6 4 17 31 20 2 0 0 0 0 7 13 4 0 0 0 6 13 4 5 17 29 21 2 0 0 0 0 8 12 5 
#Book01
0 0 0 7 13 5 5 17 30 20 3 0 0 0 0 6 13 6 0 0 0 7 12 5 5 17 28 22 1 0 0 0 0 7 12 4 
