#Desk
0 0 0 12 11 7 12 26 22 4 0 0 0 0 0 10 11 8 0 0 0 12 11 6 11 29 22 4 0 0 0 0 0 13 10 6 
#Chair09
0 0 0 6 6 9 5 11 18 25 14 6 0 0 0 2 11 6 0 0 0 2 9 7 4 12 19 29 15 7 0 0 0 6 6 8 
#Chair08
0 0 0 6 7 10 4 9 17 32 16 7 0 0 0 2 11 6 0 0 0 3 10 8 5 11 15 28 13 8 0 0 0 5 4 10 
#Chair07
0 0 0 6 6 10 4 8 17 32 17 6 0 0 0 3 11 5 0 0 0 3 10 8 5 11 16 28 13 8 0 0 0 5 4 10 
#Chair06
0 0 0 6 5 11 4 13 16 31 15 7 0 0 0 2 10 5 0 0 0 2 11 5 4 10 17 30 15 8 0 0 0 4 6 8 
#Chair05
0 0 0 4 6 11 5 12 17 31 17 7 0 0 0 2 12 7 0 0 0 3 8 6 4 11 17 26 16 5 0 0 0 5 6 8 
#Chair04
0 0 0 5 6 9 5 12 19 30 13 7 0 0 0 3 9 5 0 0 0 2 9 9 5 13 15 28 13 6 0 0 0 6 6 10 
#Chair03
0 0 0 6 6 8 5 13 19 30 12 7 0 0 0 3 9 5 0 0 0 2 8 9 5 13 14 28 14 6 0 0 0 6 6 10 
#Chair02
0 0 0 4 5 8 6 12 16 27 15 8 0 0 0 3 10 6 0 0 0 3 9 6 5 12 17 29 17 5 0 0 0 7 5 9 
#Chair014
0 0 0 4 5 7 6 12 17 27 14 8 0 0 0 2 10 6 0 0 0 3 9 7 5 12 18 28 18 6 0 0 0 7 5 8 
#Chair013
0 0 0 5 6 12 3 12 18 28 15 6 0 0 0 2 9 7 0 0 0 1 8 7 4 10 18 32 15 5 0 0 0 5 6 10 
#Chair012
0 0 0 4 6 9 5 11 20 28 15 6 0 0 0 3 10 7 0 0 0 2 11 9 4 11 15 26 17 5 0 0 0 6 6 9 
#Chair011
0 0 0 6 6 9 4 10 16 26 16 5 0 0 0 2 10 9 0 0 0 3 10 7 5 11 19 29 15 7 0 0 0 4 5 9 
#Chair010
0 0 0 6 5 9 4 10 16 28 17 6 0 0 0 3 11 8 0 0 0 3 11 7 4 11 16 28 15 6 0 0 0 6 5 10 
#Chair01
0 0 0 4 5 11 4 13 17 27 15 6 0 0 0 3 12 6 0 0 0 2 12 7 3 11 17 27 14 6 0 0 0 7 6 8 
