#Desk
0 0 4 5 5 6 8 8 6 10 13 8 8 7 6 10 6 6 7 6 10 10 9 13 10 12 6 5 4 4 4 4 5 5 5 2 
#Chair09
0 1 1 2 2 2 3 4 2 3 6 3 5 4 4 7 7 6 10 11 11 14 13 11 9 13 10 10 9 10 11 8 9 6 6 4 
#Chair08
0 0 1 2 1 2 3 3 2 3 3 3 3 3 5 5 6 7 7 12 18 17 13 9 9 11 10 9 9 12 12 10 8 8 6 4 
#Chair07
0 0 1 2 2 2 2 3 3 4 3 3 4 3 4 6 6 7 8 14 18 15 12 9 9 11 11 10 9 11 13 11 8 7 5 3 
#Chair06
0 1 1 1 1 1 3 3 4 3 5 4 3 5 6 5 6 6 8 10 14 15 15 13 11 11 9 9 9 13 9 8 7 9 5 6 
#Chair05
0 1 1 1 3 1 2 2 3 6 3 4 4 5 3 4 7 8 7 12 14 16 13 9 10 11 11 12 10 12 9 9 9 8 6 2 
#Chair04
0 0 1 3 1 3 2 4 4 4 4 5 5 5 5 6 7 5 9 10 13 15 15 12 8 11 10 9 7 10 10 9 9 9 6 3 
#Chair03
0 0 1 3 1 3 2 4 4 5 4 5 4 5 5 6 7 5 9 9 13 15 16 12 9 11 9 9 7 10 10 8 9 10 6 3 
#Chair02
0 0 2 2 2 3 2 2 4 4 6 4 4 5 4 6 6 6 10 13 11 16 13 10 9 12 11 8 10 11 7 8 8 9 6 4 
#Chair014
0 0 2 2 2 2 2 2 4 5 5 4 5 5 4 6 6 7 9 12 13 14 12 10 10 12 11 9 9 11 7 8 9 8 7 3 
#Chair013
0 0 1 2 1 2 2 2 4 2 6 4 4 4 7 5 7 6 10 11 13 18 13 11 13 9 7 10 9 10 8 8 10 9 7 5 
#Chair012
0 0 1 1 2 3 2 2 3 4 3 5 4 5 4 5 6 8 8 11 14 14 12 10 13 12 10 8 11 11 11 9 9 8 5 3 
#Chair011
0 0 1 2 2 3 2 2 3 5 3 5 5 5 5 5 6 8 8 13 13 13 12 11 11 13 10 8 10 11 10 9 9 9 5 3 
#Chair010
0 0 1 2 3 2 2 3 2 5 4 3 4 5 4 7 4 5 10 14 15 12 11 12 11 13 10 9 9 12 11 10 8 8 5 3 
#Chair01
0 0 0 2 2 2 2 3 4 5 4 4 4 6 5 5 6 7 8 11 12 14 13 11 10 9 11 10 12 12 10 9 10 6 6 3 
