#Desk
0 0 0 7 6 7 8 13 20 22 10 0 0 0 0 7 9 8 0 0 0 7 10 7 7 15 22 25 10 1 0 0 0 9 8 8 
#Chair08
0 0 0 4 3 7 1 23 51 9 1 0 0 0 0 6 8 10 0 0 0 4 9 10 1 25 46 8 1 0 0 0 0 4 3 8 
#Chair07
0 0 0 4 4 7 2 22 48 8 1 0 0 0 0 5 10 10 0 0 0 6 9 9 1 21 51 10 0 0 0 0 0 5 3 7 
#Chair06
0 0 0 4 5 9 2 23 53 8 0 0 0 0 0 4 8 10 0 0 0 4 11 9 1 20 50 8 1 0 0 0 0 5 3 7 
#Chair05
0 0 0 5 2 9 1 22 49 9 1 0 0 0 0 7 9 10 0 0 0 5 7 11 2 23 51 9 1 0 0 0 0 5 3 6 
#Chair04
0 0 0 5 3 7 0 24 50 9 1 0 0 0 0 5 8 11 0 0 0 5 9 9 1 22 48 10 1 0 0 0 0 4 5 7 
#Chair03
0 0 0 4 3 7 1 23 49 7 0 0 0 0 0 4 8 11 0 0 0 6 8 9 1 23 53 7 1 0 0 0 0 5 5 9 
#Chair02
0 0 0 3 4 8 2 23 51 7 0 0 0 0 0 3 10 10 0 0 0 4 9 9 2 25 49 8 1 0 0 0 0 4 4 7 
#Chair01
0 0 0 4 3 8 1 21 46 8 1 0 0 0 0 5 8 11 0 0 0 5 8 11 2 24 51 8 0 0 0 0 0 4 3 9 
