#Desk
0 1 2 3 4 4 3 4 4 4 4 5 4 6 5 6 7 11 15 16 12 12 12 10 11 10 11 9 6 5 7 6 4 5 4 4 
#Chair08
0 0 0 0 0 1 1 2 5 7 13 19 18 22 25 14 11 5 6 7 7 5 6 5 5 5 4 4 5 3 4 4 7 10 6 4 
#Chair07
0 0 0 0 1 1 1 2 4 7 13 13 20 24 22 15 10 7 7 7 8 7 5 4 5 5 4 5 4 5 3 7 6 9 6 2 
#Chair06
0 0 0 0 1 1 1 2 3 6 13 17 17 22 26 17 12 7 6 7 6 5 4 5 5 5 5 5 4 4 3 4 7 9 9 2 
#Chair05
0 0 0 0 1 1 1 1 5 8 14 14 20 21 24 15 10 6 7 6 7 7 7 6 4 4 4 5 3 2 4 5 7 9 7 3 
#Chair04
0 0 0 0 1 0 1 2 4 10 13 15 17 22 25 16 9 7 7 7 7 6 6 5 3 6 5 4 4 5 3 4 7 9 8 2 
#Chair03
0 0 0 0 1 1 1 3 5 8 14 13 19 23 24 15 11 7 5 6 7 7 4 5 4 5 5 5 4 4 4 5 9 8 6 3 
#Chair02
0 0 0 0 1 2 2 2 5 6 11 19 21 21 24 14 11 7 6 6 4 5 5 4 5 5 5 5 4 4 4 4 7 9 7 3 
#Chair01
0 0 0 0 1 1 2 2 4 8 14 15 17 23 24 14 11 7 6 6 7 5 6 5 4 5 4 4 5 3 4 5 8 10 10 3 
