#Desk
12 31 49 51 40 35 21 11 3 0 
#Chair08
13 38 57 57 39 26 13 6 3 0 
#Chair07
12 38 57 57 40 26 13 6 2 0 
#Chair06
12 38 56 57 39 26 13 6 3 0 
#Chair05
13 39 57 57 39 25 13 6 2 0 
#Chair04
13 38 57 58 39 25 13 6 2 0 
#Chair03
12 38 58 56 39 26 13 6 3 0 
#Chair02
13 40 58 56 38 25 12 6 3 0 
#Chair01
12 38 55 56 39 27 14 7 3 0 
