#Screen
0 0 0 0 0 1 2 2 3 2 2 6 6 7 8 10 13 12 11 11 9 12 10 10 10 11 12 11 11 13 13 9 6 4 2 0 
#Desk
0 1 3 4 5 6 7 7 9 10 9 8 8 7 4 8 6 7 8 7 10 10 11 10 13 14 8 5 5 4 4 4 4 5 3 3 
#Clock
0 0 1 2 3 4 3 6 3 2 2 2 2 3 3 3 3 4 4 4 5 6 4 4 6 7 5 7 6 8 25 17 17 17 21 31 
#Chair09
0 1 2 2 2 2 4 4 3 5 5 6 6 7 6 7 8 7 9 9 7 13 11 11 12 11 12 8 5 8 8 5 9 9 8 7 
#Chair08
0 1 1 2 2 3 4 4 3 5 5 6 6 7 6 7 7 7 9 10 8 13 11 11 12 12 12 8 5 8 8 6 9 9 8 7 
#Chair07
0 1 1 2 2 3 4 4 3 5 4 6 6 7 6 7 7 8 9 10 8 13 11 11 12 11 11 8 5 8 8 5 9 9 9 7 
#Chair06
0 1 2 2 2 3 4 4 3 5 5 6 6 7 6 7 7 7 9 9 7 13 11 11 12 12 12 8 5 8 8 5 9 9 8 7 
#Chair05
0 0 1 1 2 2 3 4 3 3 4 4 5 5 8 9 7 9 8 7 12 11 10 12 13 12 12 10 7 8 7 8 8 8 9 8 
#Chair04
0 0 0 1 2 2 2 4 3 4 4 5 6 5 8 9 7 9 8 8 11 11 10 12 14 12 11 9 7 9 7 8 8 8 8 8 
#Chair03
0 0 1 0 2 2 2 4 3 3 4 4 5 5 8 9 8 9 8 7 11 11 10 12 13 12 11 10 7 9 7 8 8 7 9 8 
#Chair02
0 1 1 1 2 3 3 2 4 4 3 6 6 8 6 7 7 7 10 9 10 12 10 11 13 14 9 8 8 6 7 9 8 10 8 7 
#Chair014
0 1 1 1 2 3 3 2 4 3 3 6 6 8 6 7 8 6 10 9 9 12 10 12 13 14 9 8 8 6 7 9 8 10 9 7 
#Chair013
0 1 1 1 2 3 3 2 4 3 3 6 6 8 6 7 8 6 10 9 10 11 10 11 13 13 8 8 8 6 8 9 8 9 8 7 
#Chair012
0 1 2 1 2 2 4 4 5 4 3 6 5 6 6 9 5 9 10 8 9 11 12 13 13 10 9 7 7 7 9 7 9 8 9 8 
#Chair011
0 1 1 1 1 3 4 3 4 5 5 5 5 6 8 6 8 7 8 8 10 11 9 13 11 13 11 7 8 6 10 8 8 10 8 7 
#Chair010
0 1 1 1 1 3 4 3 4 5 4 5 5 6 8 6 8 8 8 8 10 10 9 13 11 13 11 7 8 6 10 9 8 11 8 7 
#Chair01
0 1 2 1 2 3 4 4 5 4 3 6 4 6 6 9 5 9 9 8 9 10 12 13 14 10 9 8 7 7 9 7 8 8 9 8 
