#Screen
0 0 0 8 12 7 7 6 5 6 7 5 8 9 10 0 0 0 0 0 0 13 14 14 16 13 9 8 13 16 14 11 11 0 0 0 
#Desk
0 1 3 5 10 12 10 11 13 12 7 9 11 12 3 2 1 0 0 2 3 3 9 14 9 10 11 12 9 8 11 10 4 2 1 0 
#Clock
0 2 3 5 6 9 9 12 14 13 10 9 8 9 7 4 3 0 0 1 3 6 7 7 10 10 14 14 11 8 10 6 6 4 0 0 
#Chair09
0 0 1 4 6 6 7 7 33 14 1 3 18 10 6 1 0 0 0 1 1 5 12 20 3 2 16 33 8 5 5 7 2 3 0 0 
#Chair08
0 0 1 4 6 7 8 7 33 14 1 3 18 10 6 1 0 0 0 0 1 5 11 19 3 1 16 33 8 6 6 7 2 3 0 0 
#Chair07
0 0 1 4 6 6 7 8 33 15 1 3 18 10 6 1 0 0 0 0 1 5 11 20 3 1 16 33 8 6 5 7 3 3 0 0 
#Chair06
0 0 1 4 6 7 7 7 33 14 1 3 18 10 6 1 0 0 0 1 1 5 11 20 3 2 16 33 8 6 6 7 2 3 0 0 
#Chair05
0 0 3 3 8 6 7 5 28 15 2 4 23 9 6 1 0 0 0 0 1 5 10 21 3 2 14 27 9 8 6 5 4 3 0 0 
#Chair04
0 0 3 3 8 6 7 5 28 16 3 4 24 9 6 1 0 0 0 1 1 5 10 20 3 2 14 28 9 8 6 5 3 3 0 0 
#Chair03
0 0 3 3 8 6 8 5 28 15 2 4 24 9 6 1 0 0 0 0 1 5 10 21 3 2 14 27 9 8 6 5 4 3 0 0 
#Chair02
0 0 2 4 7 7 8 8 30 15 2 3 21 10 5 1 0 0 0 0 1 7 10 21 3 2 14 31 7 7 7 5 3 3 0 0 
#Chair014
0 0 2 3 7 6 9 8 30 15 3 2 20 10 5 1 0 0 0 0 1 7 10 22 3 2 15 31 7 7 7 5 3 3 0 0 
#Chair013
0 0 2 3 7 6 9 8 30 15 3 3 20 10 5 1 0 0 0 0 1 7 10 21 3 2 14 31 7 7 7 5 3 3 0 0 
#Chair012
0 0 3 2 5 7 7 6 32 14 1 3 18 12 7 2 0 0 0 1 1 4 12 20 4 3 14 29 8 7 7 6 2 2 0 0 
#Chair011
0 0 3 3 5 7 5 7 29 15 3 3 19 12 6 2 0 0 0 0 1 7 11 21 4 2 16 29 8 6 9 7 2 2 0 0 
#Chair010
0 0 2 4 6 7 6 7 29 14 3 3 19 12 6 2 0 0 0 0 1 6 12 20 4 2 16 29 8 6 9 7 2 2 0 0 
#Chair01
0 0 3 2 5 7 7 7 31 14 1 3 19 12 7 2 0 0 0 1 1 4 12 21 3 3 15 29 8 7 7 6 2 2 0 0 
