#Screen
17 36 41 40 37 31 25 18 6 0 
#Desk
22 55 48 39 29 23 19 11 4 0 
#Clock
9 20 28 36 41 36 29 25 20 8 
#Chair09
9 23 39 54 54 36 20 11 4 0 
#Chair08
9 23 39 54 54 36 20 12 4 0 
#Chair07
9 23 39 55 54 36 20 11 4 0 
#Chair06
9 23 39 54 54 36 20 12 4 0 
#Chair05
9 22 38 52 53 38 22 13 4 0 
#Chair04
9 22 39 52 53 37 21 13 4 0 
#Chair03
9 22 38 52 53 37 22 13 4 0 
#Chair02
9 22 40 53 53 36 20 12 4 0 
#Chair014
9 22 40 53 53 37 20 12 4 0 
#Chair013
9 22 40 53 53 36 20 12 4 0 
#Chair012
9 23 41 54 53 36 20 12 4 0 
#Chair011
9 22 40 53 54 36 21 13 4 0 
#Chair010
9 22 40 53 54 36 21 13 4 0 
#Chair01
9 23 40 54 53 36 20 12 4 0 
