#Screen
0 0 0 5 14 8 2 8 17 10 1 0 0 0 0 6 13 9 0 0 0 10 20 11 2 10 41 22 0 0 0 0 0 9 19 9 
#Desk
0 0 0 13 13 7 10 28 20 5 0 0 0 0 0 10 14 5 0 0 0 14 12 6 10 26 22 3 0 0 0 0 0 11 13 5 
#Clock
0 0 0 2 5 18 6 11 10 10 9 23 0 0 0 1 6 24 0 0 0 2 5 18 5 10 10 9 9 23 0 0 0 2 5 21 
#Chair09
0 0 0 3 9 6 5 15 21 20 6 0 0 0 0 7 12 17 0 0 0 8 14 18 6 14 22 22 5 0 0 0 0 1 11 6 
#Chair08
0 0 0 2 9 6 4 15 21 20 6 0 0 0 0 7 12 18 0 0 0 7 13 17 6 13 22 22 5 0 0 0 0 1 11 6 
#Chair07
0 0 0 2 9 6 4 15 22 21 6 0 0 0 0 7 12 17 0 0 0 8 13 18 6 13 22 22 5 0 0 0 0 1 11 6 
#Chair06
0 0 0 3 9 6 4 15 21 19 6 0 0 0 0 7 12 17 0 0 0 8 14 18 6 14 22 22 5 0 0 0 0 1 11 6 
#Chair05
0 0 0 2 12 6 3 12 22 20 6 0 0 0 0 9 14 17 0 0 0 7 13 18 3 11 23 20 7 0 0 0 0 2 10 7 
#Chair04
0 0 0 3 12 6 4 12 22 19 6 0 0 0 0 9 14 17 0 0 0 7 13 18 3 11 23 20 7 0 0 0 0 2 10 7 
#Chair03
0 0 0 2 12 6 3 12 22 20 6 0 0 0 0 9 14 17 0 0 0 7 14 18 3 11 23 19 7 0 0 0 0 2 10 7 
#Chair02
0 0 0 1 11 7 5 13 20 23 6 0 0 0 0 8 12 17 0 0 0 8 13 19 5 12 22 20 5 0 0 0 0 1 11 7 
#Chair014
0 0 0 1 12 7 4 12 21 23 6 0 0 0 0 7 12 18 0 0 0 9 13 19 5 12 22 21 5 0 0 0 0 1 10 6 
#Chair013
0 0 0 1 11 7 5 13 20 23 6 0 0 0 0 8 12 18 0 0 0 9 12 19 5 12 22 20 4 0 0 0 0 1 11 7 
#Chair012
0 0 0 2 8 7 4 13 21 20 5 0 0 0 0 8 13 20 0 0 0 8 13 18 5 15 20 21 5 0 0 0 0 2 10 6 
#Chair011
0 0 0 3 9 7 4 13 22 17 4 0 0 0 0 8 13 19 0 0 0 8 13 20 4 14 20 20 6 0 0 0 0 2 12 6 
#Chair010
0 0 0 3 9 7 4 13 22 17 5 0 0 0 0 8 13 19 0 0 0 8 12 20 4 14 20 20 6 0 0 0 0 2 12 6 
#Chair01
0 0 0 2 8 7 4 13 20 20 6 0 0 0 0 8 13 19 0 0 0 8 14 18 5 15 20 21 5 0 0 0 0 2 10 6 
