#Desk
0 0 0 5 14 13 0 15 32 15 0 0 0 0 0 4 12 13 0 0 0 6 16 13 0 16 29 16 0 0 0 0 0 3 12 12 
#Chair09
0 0 0 3 2 3 2 21 43 28 2 1 0 0 0 4 11 8 0 0 0 4 11 7 1 22 37 25 2 1 0 0 0 1 3 3 
#Chair08
0 0 0 2 2 2 1 23 42 27 2 1 0 0 0 3 11 6 0 0 0 4 11 7 1 22 44 25 1 0 0 0 0 2 2 2 
#Chair07
0 0 0 1 3 4 1 23 43 24 2 1 0 0 0 4 10 7 0 0 0 5 10 7 1 21 43 26 2 1 0 0 0 1 3 2 
#Chair06
0 0 0 2 3 3 0 22 42 24 2 1 0 0 0 4 9 8 0 0 0 3 9 8 2 19 44 30 2 1 0 0 0 2 2 3 
#Chair05
0 0 0 2 3 2 1 22 42 29 1 1 0 0 0 5 12 6 0 0 0 3 10 8 0 22 41 24 2 1 0 0 0 1 2 3 
#Chair04
0 0 0 1 3 3 1 23 40 23 1 1 0 0 0 4 11 7 0 0 0 3 11 7 1 23 45 25 2 1 0 0 0 2 3 2 
#Chair03
0 0 0 2 2 2 1 23 43 26 1 1 0 0 0 5 10 7 0 0 0 3 13 7 1 20 44 23 1 2 0 0 0 1 2 3 
#Chair02
0 0 0 2 3 4 1 20 40 24 3 1 0 0 0 5 9 8 0 0 0 4 10 7 1 25 41 25 2 1 0 0 0 2 2 4 
#Chair012
0 0 0 2 4 2 1 22 41 25 3 1 0 0 0 4 9 8 0 0 0 3 11 7 1 22 40 28 1 1 0 0 0 1 3 3 
#Chair011
0 0 0 2 2 3 2 20 42 24 2 1 0 0 0 5 11 8 0 0 0 4 10 6 1 24 45 21 2 1 0 0 0 2 3 3 
#Chair010
0 0 0 1 4 3 2 22 43 28 2 2 0 0 0 4 10 8 0 0 0 3 10 8 1 24 40 23 1 1 0 0 0 2 2 2 
#Chair01
0 0 0 1 3 3 0 24 43 22 2 1 0 0 0 4 13 8 0 0 0 4 11 10 2 20 38 27 2 2 0 0 0 2 2 3 
#Bookshelf
0 0 0 4 9 11 2 21 38 12 0 0 0 0 0 2 7 12 0 0 0 5 11 10 1 24 38 17 0 0 0 0 0 4 9 7 
