#Desk
13 34 44 46 41 29 21 15 7 1 
#Chair09
10 32 51 60 49 30 12 4 1 0 
#Chair08
11 34 53 62 49 28 11 3 1 0 
#Chair07
11 33 52 62 49 28 11 3 1 0 
#Chair06
11 33 52 61 50 29 12 3 1 0 
#Chair05
11 33 52 61 50 29 11 3 1 0 
#Chair04
11 34 54 61 48 29 11 3 1 0 
#Chair03
11 34 53 60 49 29 11 3 1 0 
#Chair02
10 33 52 61 49 29 12 4 1 0 
#Chair012
10 32 52 61 50 29 11 4 1 0 
#Chair011
11 33 53 61 49 29 11 4 1 0 
#Chair010
11 34 53 61 48 28 11 4 1 0 
#Chair01
11 33 51 59 49 31 13 4 1 0 
#Bookshelf
8 37 52 53 42 28 16 9 5 0 
