#Projector
6 18 36 49 47 41 30 18 5 0 
#Pad
11 27 36 41 40 36 31 23 6 0 
#Mouse
6 21 47 50 46 34 22 14 8 3 
#Keyboard
17 43 50 43 32 25 19 13 7 1 
#Desk
9 33 52 47 43 34 21 9 3 0 
#Chair06
17 48 69 58 33 16 8 2 0 0 
#Chair05
17 46 69 58 35 17 8 2 0 0 
#Chair04
17 46 69 59 34 16 8 2 0 0 
#Chair03
16 45 67 59 35 17 8 3 0 0 
#Chair02
16 45 69 59 34 17 8 3 0 0 
#Chair01
16 45 69 58 35 16 8 2 0 0 
