#Projector
0 0 0 0 0 0 0 0 0 0 4 5 5 6 5 6 8 8 9 11 11 12 11 15 12 13 11 16 20 16 12 9 6 6 4 2 
#Pad
0 0 0 1 1 1 2 1 1 0 0 1 0 1 3 5 9 9 7 9 10 10 10 10 10 9 11 9 13 23 24 19 12 9 6 3 
#Mouse
0 0 0 0 0 0 0 3 3 5 6 7 5 7 6 8 9 9 13 18 13 10 10 9 9 11 7 7 6 9 7 7 8 8 10 12 
#Keyboard
0 0 1 2 4 4 5 4 6 7 9 9 9 8 11 8 9 9 9 8 9 7 7 6 6 7 8 6 8 7 11 7 6 6 9 4 
#Desk
0 0 0 0 2 3 4 6 5 5 7 11 10 9 11 11 11 10 11 11 11 10 8 7 7 6 7 6 8 7 6 7 5 5 7 7 
#Chair06
0 0 0 0 0 0 2 9 10 14 17 19 22 23 24 16 10 7 8 6 7 7 8 4 4 1 2 3 2 3 3 2 3 3 2 2 
#Chair05
0 0 0 0 0 0 2 8 10 11 16 19 20 25 22 16 10 7 8 10 8 9 7 5 5 2 2 1 3 1 2 2 2 3 2 1 
#Chair04
0 0 0 0 0 0 3 7 11 11 17 20 18 24 23 19 11 8 8 9 6 7 8 4 3 2 1 2 3 2 3 2 2 2 3 2 
#Chair03
0 0 0 0 0 0 3 7 9 11 17 17 21 24 20 18 11 10 9 8 6 8 8 4 5 3 3 2 1 2 3 3 1 2 2 2 
#Chair02
0 0 0 0 0 0 3 7 9 14 13 19 22 23 22 16 12 6 6 8 8 10 8 6 4 2 2 2 3 2 3 2 2 3 2 1 
#Chair01
0 0 0 0 0 0 2 7 9 12 17 18 21 22 22 16 12 8 8 8 8 7 9 5 5 2 2 2 2 2 2 3 2 2 2 1 
