#Projector
0 0 0 3 15 10 10 13 11 12 12 11 9 22 0 0 0 0 0 0 0 0 17 9 14 11 10 12 10 11 9 12 3 0 0 0 
#Pad
0 1 6 11 11 0 0 1 13 19 17 15 15 11 0 0 0 0 0 0 0 0 10 13 17 15 24 13 2 0 1 9 11 6 1 0 
#Mouse
0 2 4 6 8 11 8 11 12 12 11 10 7 7 4 4 2 1 1 3 5 5 5 7 9 13 14 11 11 10 8 7 4 3 2 0 
#Keyboard
0 2 4 10 8 11 11 12 12 12 12 14 8 9 6 4 3 0 0 2 4 5 6 8 8 8 9 10 10 9 7 6 6 3 1 0 
#Desk
0 4 2 3 4 8 15 9 12 16 14 12 12 11 0 0 0 0 0 0 0 0 7 9 15 17 15 14 12 15 8 4 3 2 2 0 
#Chair06
0 1 2 2 3 8 9 11 28 11 20 15 4 3 1 0 0 0 0 0 0 1 1 5 16 23 12 26 12 11 7 2 2 2 1 0 
#Chair05
0 2 3 3 2 8 8 12 24 11 18 18 6 2 0 0 0 0 0 0 0 1 3 4 16 25 11 26 13 9 10 2 2 2 1 0 
#Chair04
0 1 1 2 2 6 11 11 25 11 21 16 5 2 1 0 0 0 0 0 0 1 2 3 19 22 8 31 11 9 8 1 3 2 2 0 
#Chair03
0 2 1 3 3 9 8 11 25 11 19 16 4 3 1 0 0 0 0 0 0 1 3 4 18 21 13 28 11 9 9 2 3 1 1 0 
#Chair02
0 1 3 3 3 9 8 10 29 8 20 17 6 2 1 0 0 0 0 0 1 1 3 5 16 25 9 28 12 9 8 2 2 1 0 0 
#Chair01
0 1 1 3 2 6 9 11 25 13 21 17 5 4 1 0 0 0 0 0 0 1 3 5 18 22 11 24 14 7 10 3 2 2 1 0 
