#Projector
0 0 0 1 17 9 0 5 21 31 13 0 0 0 0 2 18 11 0 0 0 2 13 10 0 6 19 30 14 0 0 0 0 1 14 10 
#Pad
0 0 0 0 7 24 2 3 15 22 16 6 0 0 0 6 11 8 0 0 0 5 12 6 2 5 13 24 22 7 0 0 0 0 7 23 
#Mouse
0 0 0 3 15 13 0 13 21 30 1 0 0 0 0 3 11 12 0 0 0 3 9 15 0 12 26 31 0 0 0 0 0 2 13 12 
#Keyboard
0 0 0 9 13 15 7 20 35 11 0 0 0 0 0 7 12 13 0 0 0 8 9 9 7 22 22 4 0 0 0 0 0 7 9 8 
#Desk
0 0 0 6 6 9 3 19 30 19 5 0 0 0 0 3 9 10 0 0 0 0 8 8 3 21 33 23 5 2 0 0 0 7 6 7 
#Chair06
0 0 0 8 5 5 0 35 50 10 0 0 0 0 0 2 4 3 0 0 0 3 3 3 0 37 54 11 0 0 0 0 0 7 4 4 
#Chair05
0 0 0 8 5 6 0 32 49 12 0 0 0 0 0 4 3 2 0 0 0 2 4 3 0 35 53 12 0 0 0 0 0 9 4 4 
#Chair04
0 0 0 6 3 5 0 35 51 11 0 0 0 0 0 3 5 2 0 0 0 2 3 2 0 35 55 12 0 0 0 0 0 8 3 6 
#Chair03
0 0 0 9 4 6 0 30 51 10 0 0 0 0 0 2 4 2 0 0 0 2 5 3 0 36 54 12 0 0 0 0 0 8 5 4 
#Chair02
0 0 0 9 5 6 0 34 50 11 0 0 0 0 0 4 4 2 0 0 0 3 4 3 0 33 54 12 0 0 0 0 0 8 4 3 
#Chair01
0 0 0 6 3 4 0 34 52 12 0 0 0 0 0 4 5 2 0 0 0 3 4 2 0 34 51 11 0 0 0 0 0 9 4 5 
