#TV
0 0 0 6 12 4 5 17 25 38 1 0 0 0 0 7 11 7 0 0 0 6 11 5 4 15 28 17 1 0 0 0 0 6 12 6 
#Table
0 0 0 0 9 19 0 2 28 18 1 0 0 0 0 2 13 18 0 0 0 1 14 21 0 0 33 28 1 0 0 0 0 2 14 22 
#Sofa
0 0 0 7 17 12 3 18 46 19 0 0 0 0 0 5 18 16 0 0 0 5 11 8 4 15 20 7 0 0 0 0 0 5 8 3 
#Desk
0 0 0 11 8 7 9 35 22 6 0 0 0 0 0 12 12 7 0 0 0 10 10 6 9 28 23 4 0 0 0 0 0 11 8 8 
#Chair09
0 0 0 1 4 4 1 6 12 38 19 6 0 0 0 6 15 14 0 0 0 4 14 13 2 5 13 36 15 5 0 0 0 0 5 5 
#Chair08
0 0 0 1 5 5 2 5 15 35 16 3 0 0 0 6 12 11 0 0 0 4 15 13 2 4 11 42 18 7 0 0 0 1 6 4 
#Chair07
0 0 0 1 5 5 1 4 14 36 16 3 0 0 0 6 12 12 0 0 0 4 16 13 2 4 12 42 18 7 0 0 0 1 6 4 
#Chair06
0 0 0 1 6 4 1 5 12 37 18 5 0 0 0 6 11 14 0 0 0 5 12 12 1 5 13 43 18 6 0 0 0 1 5 4 
#Chair05
0 0 0 1 7 5 2 4 11 37 17 3 0 0 0 6 13 13 0 0 0 4 14 14 1 4 15 40 19 7 0 0 0 1 4 5 
#Chair04
0 0 0 0 6 4 1 5 14 40 18 4 0 0 0 5 10 13 0 0 0 4 18 12 2 5 13 40 15 3 0 0 0 1 5 6 
#Chair03
0 0 0 0 6 4 1 5 13 40 18 4 0 0 0 6 11 13 0 0 0 4 17 12 2 6 13 39 15 3 0 0 0 1 5 6 
#Chair02
0 0 0 1 4 4 1 4 15 41 17 3 0 0 0 6 12 16 0 0 0 3 13 12 2 3 12 37 19 7 0 0 0 2 4 4 
#Chair014
0 0 0 1 7 4 1 3 13 34 18 4 0 0 0 5 13 13 0 0 0 5 14 16 1 4 14 43 18 6 0 0 0 0 5 3 
#Chair013
0 0 0 1 6 6 1 5 9 39 17 3 0 0 0 4 11 14 0 0 0 4 15 11 1 5 12 45 18 6 0 0 0 1 6 5 
#Chair012
0 0 0 1 6 6 1 5 10 38 17 3 0 0 0 4 12 14 0 0 0 4 14 11 1 5 12 44 18 6 0 0 0 1 6 5 
#Chair011
0 0 0 0 5 3 1 5 13 36 17 5 0 0 0 5 12 14 0 0 0 3 16 14 1 5 14 40 16 7 0 0 0 1 4 5 
#Chair010
0 0 0 1 4 6 1 5 13 37 19 4 0 0 0 5 14 14 0 0 0 3 15 13 1 4 14 40 17 4 0 0 0 1 5 4 
#Chair01
0 0 0 2 5 5 2 6 16 38 16 3 0 0 0 5 12 11 0 0 0 5 11 12 1 5 13 39 19 6 0 0 0 2 7 4 
