#TV
0 0 1 1 2 3 3 4 4 7 6 7 6 8 9 9 10 11 11 14 10 14 19 12 10 7 9 7 8 7 7 6 3 3 2 0 
#Table
0 0 0 0 0 0 0 0 0 0 0 2 3 6 10 12 13 15 10 8 9 10 7 7 9 7 8 7 10 11 18 17 21 13 9 2 
#Sofa
0 0 1 1 2 3 3 4 6 7 6 5 11 9 9 12 12 11 9 7 8 7 9 8 8 8 8 10 11 8 9 10 9 6 3 1 
#Desk
0 1 2 4 4 5 6 8 9 15 13 10 7 7 7 7 6 8 11 11 9 6 7 8 8 6 7 7 4 6 5 5 4 3 5 4 
#Chair09
0 0 0 0 1 1 1 1 1 2 2 2 3 3 3 3 3 9 9 14 19 13 16 15 13 12 11 13 12 12 15 10 10 5 4 1 
#Chair08
0 0 0 0 1 1 2 0 1 2 1 1 4 3 2 3 4 9 9 14 16 17 17 16 13 13 9 12 11 14 12 14 10 6 2 1 
#Chair07
0 0 0 0 1 1 2 0 1 1 1 1 4 3 2 3 4 8 9 14 16 16 18 17 13 13 9 12 11 14 12 15 10 5 2 1 
#Chair06
0 0 0 0 1 1 1 1 1 2 1 1 4 3 2 2 3 9 9 13 20 16 18 18 14 9 10 10 13 13 14 13 9 5 3 1 
#Chair05
0 0 0 0 1 0 1 0 1 1 1 1 4 2 3 2 3 9 9 13 18 15 18 15 13 10 11 11 12 17 13 13 11 6 3 2 
#Chair04
0 0 0 0 0 0 0 1 2 1 2 2 3 3 3 3 3 10 12 15 18 14 17 14 14 11 12 9 13 13 13 12 9 4 4 1 
#Chair03
0 0 0 0 0 0 0 1 2 1 2 2 3 3 2 2 4 10 12 15 18 14 18 15 14 11 12 9 13 13 14 12 9 4 3 1 
#Chair02
0 0 0 1 0 1 0 1 1 1 1 1 5 3 3 3 4 8 11 14 19 15 15 16 13 12 10 9 11 16 14 14 9 5 3 1 
#Chair014
0 0 0 0 0 1 0 1 1 1 0 1 3 3 3 3 3 9 11 12 20 14 17 14 14 13 12 11 11 15 12 14 10 5 3 1 
#Chair013
0 0 0 0 0 0 0 0 1 2 2 3 3 3 2 2 3 7 13 14 18 13 18 16 13 14 13 8 11 13 12 13 10 6 2 2 
#Chair012
0 0 0 0 1 0 0 1 1 2 2 2 3 3 2 2 3 7 12 14 18 13 19 16 13 14 12 8 11 13 12 13 10 5 2 2 
#Chair011
0 0 0 0 1 1 0 1 1 2 2 2 3 2 4 2 3 10 10 12 17 14 18 16 11 12 10 10 13 13 15 14 10 6 3 1 
#Chair010
0 0 0 0 0 1 1 1 1 2 1 1 3 3 3 2 3 11 9 13 19 16 16 14 13 12 13 11 13 12 12 12 8 6 3 1 
#Chair01
0 0 0 1 1 1 2 1 1 2 2 2 4 3 2 4 4 10 11 13 18 16 16 15 15 13 11 8 11 12 11 12 10 5 2 1 
