#TV
0 0 0 1 0 2 3 5 3 5 5 6 6 8 8 9 11 9 11 11 11 11 11 12 10 11 14 10 10 9 11 6 4 4 2 1 
#Speaker02
0 0 0 0 0 0 0 0 0 0 0 0 1 1 1 2 6 6 8 7 11 15 18 22 13 17 18 18 18 18 14 11 10 6 2 0 
#Speaker01
0 0 0 0 0 0 0 0 0 0 0 0 1 1 1 2 6 8 7 6 11 14 14 21 19 16 19 17 18 17 15 11 10 6 3 1 
#Desk
0 1 3 5 6 6 6 8 11 9 10 7 8 7 6 7 6 7 7 7 9 9 9 9 13 12 10 6 4 5 6 5 4 3 4 3 
#Chair09
0 0 1 1 2 2 4 4 3 4 5 5 5 5 6 8 8 8 8 9 9 13 12 13 14 9 11 10 6 6 9 9 8 9 7 6 
#Chair08
0 1 1 2 2 2 3 4 4 4 5 6 5 5 7 8 8 7 9 8 9 12 12 12 13 10 11 9 6 6 9 8 8 11 7 6 
#Chair07
0 0 1 2 2 3 4 3 4 4 4 6 5 4 4 7 6 9 10 8 8 11 10 13 15 13 9 10 7 8 8 6 9 9 12 4 
#Chair06
0 0 1 2 2 3 3 3 4 4 3 6 6 4 5 7 6 9 10 8 8 11 11 13 14 14 9 10 6 7 8 6 9 10 12 6 
#Chair05
0 1 1 2 2 3 3 3 3 4 3 6 6 4 5 7 7 9 10 7 9 10 11 13 14 14 8 10 7 7 10 6 9 9 11 5 
#Chair04
0 0 1 2 3 3 3 4 3 4 5 5 4 6 6 6 7 10 8 9 12 13 12 13 12 13 10 8 7 5 7 9 8 7 9 6 
#Chair03
0 0 1 2 3 4 3 3 3 4 5 5 4 7 6 6 7 11 8 8 12 12 11 12 12 13 10 7 7 5 7 9 8 6 9 5 
#Chair02
0 0 1 2 2 4 3 3 3 4 5 5 4 7 6 6 7 11 8 9 11 13 11 13 12 13 10 8 7 5 7 9 8 7 8 6 
#Chair014
0 1 1 2 3 3 3 3 3 4 5 5 4 6 6 6 8 11 9 9 11 13 12 13 12 13 10 9 6 6 6 9 8 7 9 5 
#Chair013
0 0 1 1 2 3 3 5 3 3 6 6 5 4 7 8 6 8 10 8 10 12 10 13 13 13 13 8 6 9 5 7 9 8 8 7 
#Chair012
0 0 1 1 2 3 3 4 3 3 6 6 5 4 6 8 6 8 10 8 9 12 11 12 13 12 13 8 7 8 6 6 9 7 8 7 
#Chair011
0 0 1 1 2 3 3 4 3 3 6 6 5 4 6 7 6 8 10 8 9 11 10 13 14 13 13 9 6 8 6 6 9 7 9 7 
#Chair010
0 0 1 1 2 3 3 4 3 3 6 6 5 4 6 8 6 8 10 8 9 11 11 13 13 12 13 8 7 8 6 6 9 7 8 7 
#Chair01
0 1 2 1 2 3 3 4 3 3 5 4 4 7 7 7 8 8 11 7 10 9 11 12 12 11 12 6 7 7 9 10 8 10 8 6 
#Carpet
0 1 1 2 3 4 5 5 5 6 7 8 10 11 10 11 12 10 9 9 9 9 8 8 8 9 10 9 7 7 8 7 6 3 1 0 
