#TV
0 0 0 3 14 7 2 13 25 32 12 0 0 0 0 4 14 6 0 0 0 5 11 8 2 17 27 18 0 0 0 0 0 6 12 7 
#Speaker02
0 0 0 0 14 11 0 0 9 40 22 0 0 0 0 4 18 9 0 0 0 3 14 13 0 0 10 35 20 0 0 0 0 0 14 11 
#Speaker01
0 0 0 0 16 12 0 0 10 37 23 0 0 0 0 2 15 11 0 0 0 3 15 10 0 0 10 31 23 0 0 0 0 0 15 12 
#Desk
0 0 0 9 14 6 12 27 21 3 0 0 0 0 0 12 12 8 0 0 0 11 13 6 11 26 21 3 0 0 0 0 0 12 12 6 
#Chair09
0 0 0 2 9 8 4 13 21 22 7 0 0 0 0 9 12 17 0 0 0 9 12 18 4 14 20 19 7 0 0 0 0 1 11 7 
#Chair08
0 0 0 2 8 8 5 14 21 22 6 0 0 0 0 9 13 17 0 0 0 10 12 16 4 14 20 19 7 0 0 0 0 1 10 7 
#Chair07
0 0 0 2 10 6 4 13 19 18 6 0 0 0 0 8 13 16 0 0 0 9 13 21 5 13 20 20 8 0 0 0 0 4 12 7 
#Chair06
0 0 0 7 12 17 4 13 19 18 7 0 0 0 0 2 9 6 0 0 0 4 11 7 5 13 19 20 8 0 0 0 0 10 13 22 
#Chair05
0 0 0 8 12 17 4 12 20 18 6 0 0 0 0 2 9 6 0 0 0 4 11 7 5 13 19 20 8 0 0 0 0 9 13 21 
#Chair04
0 0 0 6 13 14 6 12 23 19 5 0 0 0 0 4 9 7 0 0 0 3 9 7 5 14 19 24 7 0 0 0 0 10 12 17 
#Chair03
0 0 0 6 13 14 7 12 24 18 5 0 0 0 0 4 9 8 0 0 0 3 9 8 5 14 19 24 7 0 0 0 0 9 12 16 
#Chair02
0 0 0 6 13 14 6 12 24 18 5 0 0 0 0 4 9 7 0 0 0 3 9 8 4 14 19 24 7 0 0 0 0 10 12 16 
#Chair014
0 0 0 4 9 7 6 12 23 19 5 0 0 0 0 6 13 14 0 0 0 10 12 16 5 13 19 24 7 0 0 0 0 3 9 8 
#Chair013
0 0 0 1 11 7 4 15 20 19 6 0 0 0 0 11 12 15 0 0 0 6 15 16 4 13 20 21 7 0 0 0 0 2 11 7 
#Chair012
0 0 0 2 11 7 4 15 19 20 6 0 0 0 0 11 13 15 0 0 0 6 16 16 5 12 20 21 7 0 0 0 0 3 11 7 
#Chair011
0 0 0 2 11 7 4 15 19 20 7 0 0 0 0 11 12 15 0 0 0 6 15 17 5 13 19 20 7 0 0 0 0 3 11 7 
#Chair010
0 0 0 2 10 7 4 15 20 20 7 0 0 0 0 11 12 15 0 0 0 6 15 16 5 12 20 21 7 0 0 0 0 3 10 7 
#Chair01
0 0 0 12 10 19 6 13 23 21 6 0 0 0 0 2 9 7 0 0 0 2 10 9 4 12 21 16 6 0 0 0 0 7 14 18 
#Carpet
0 0 0 7 11 7 7 20 33 12 0 0 0 0 0 7 13 7 0 0 0 9 12 6 7 19 33 11 0 0 0 0 0 8 14 5 
