#TV02
0 0 1 4 4 5 6 6 6 7 9 11 13 11 9 2 0 0 0 0 1 10 14 13 14 17 19 17 13 11 7 6 5 1 0 0 
#TV01
0 0 1 4 4 5 6 7 7 7 9 11 13 11 9 2 0 0 0 0 1 9 14 13 14 16 19 17 14 11 7 6 5 2 0 0 
#Screen
0 0 0 2 9 8 12 9 13 14 13 10 10 9 3 0 0 0 0 0 0 3 10 12 13 12 14 16 16 13 10 10 2 0 0 0 
#Projector
0 0 3 8 6 8 7 13 12 18 15 11 8 7 7 0 0 0 0 0 0 9 7 9 10 11 15 13 12 9 9 8 9 2 0 0 
#Notebook02
0 0 0 0 6 15 19 19 13 17 16 15 13 7 0 0 0 0 0 0 0 0 7 9 12 13 12 12 12 13 10 7 0 0 0 0 
#Notebook01
0 0 0 0 5 14 17 17 16 18 17 16 14 7 0 0 0 0 0 0 0 0 8 10 13 12 13 11 12 11 8 9 0 0 0 0 
#Desk
0 0 3 5 5 7 15 10 12 10 8 13 7 5 5 4 0 0 0 0 4 4 7 10 12 12 15 14 11 15 10 9 6 4 0 0 
#Cup
0 0 2 1 1 28 13 11 15 13 10 10 7 6 5 12 0 0 0 0 12 5 8 7 9 8 11 12 7 8 16 0 2 4 0 0 
#Chair09
0 0 1 1 5 10 17 23 13 14 12 10 7 4 5 5 0 0 0 0 3 4 5 6 5 10 15 13 24 17 5 6 1 0 0 0 
#Chair08
0 0 1 1 6 9 15 24 14 13 13 9 7 4 5 3 0 0 0 0 4 5 4 5 9 14 11 14 20 15 4 7 1 2 0 0 
#Chair07
0 1 1 1 4 9 15 23 17 13 12 7 6 5 6 3 0 0 0 0 4 5 5 8 8 12 13 11 23 17 6 3 2 1 0 0 
#Chair06
0 0 2 2 6 11 15 21 15 12 9 8 5 6 5 4 0 0 0 0 4 5 5 8 7 12 13 13 21 17 7 6 2 1 0 0 
#Chair05
0 0 1 1 6 10 16 22 13 12 12 6 7 6 6 5 0 0 0 0 5 5 5 6 7 11 13 15 22 17 6 6 1 1 0 0 
#Chair04
0 0 1 2 5 11 17 22 14 10 12 9 7 7 3 5 0 0 0 0 5 5 6 6 7 10 13 13 21 16 7 7 2 1 0 0 
#Chair03
0 0 1 1 6 8 17 22 14 12 12 6 5 5 4 5 0 0 0 0 4 5 6 7 7 13 12 18 23 16 6 5 1 1 0 0 
#Chair02
0 0 1 1 7 11 17 22 16 12 14 6 6 5 4 4 0 0 0 0 4 5 7 6 6 13 12 13 19 17 5 7 1 1 0 0 
#Chair01
0 0 1 2 6 11 15 22 14 12 12 8 7 6 4 5 0 0 0 0 5 6 6 7 6 11 13 11 22 17 5 7 2 0 0 0 
#CellingLight04
0 1 2 5 9 11 11 12 13 13 10 8 9 4 5 3 1 0 0 2 3 5 6 9 12 12 12 11 13 11 8 6 5 3 1 0 
#CellingLight03
0 1 3 4 7 10 11 13 11 14 12 9 8 7 4 3 1 0 1 1 2 4 6 10 12 11 13 10 11 11 8 8 6 3 1 0 
#CellingLight02
0 1 3 5 8 11 11 14 10 14 10 10 9 6 4 2 2 0 0 2 4 3 8 9 11 12 13 11 10 11 7 8 6 3 1 0 
#CellingLight01
0 1 2 6 7 10 13 13 13 13 10 9 8 6 5 4 1 0 0 2 3 2 7 8 12 12 11 12 11 12 9 7 3 3 2 0 
#Book
0 0 0 7 8 8 10 11 12 11 12 12 10 8 7 0 0 0 0 0 0 8 10 11 11 12 13 13 10 13 10 8 6 0 0 0 
