#TV02
0 0 0 3 6 5 4 13 20 7 0 0 0 0 0 12 16 8 0 0 0 11 19 8 9 30 41 11 0 0 0 0 0 6 8 6 
#TV01
0 0 0 3 6 5 4 14 20 7 0 0 0 0 0 12 16 8 0 0 0 11 19 9 10 30 41 10 0 0 0 0 0 6 8 7 
#Screen
0 0 0 4 10 4 4 13 27 22 5 0 0 0 0 5 12 6 0 0 0 6 13 7 4 17 26 33 6 0 0 0 0 4 14 5 
#Projector
0 0 0 3 8 14 1 15 22 28 11 0 0 0 0 3 10 9 0 0 0 4 12 9 1 12 23 25 7 0 0 0 0 4 9 15 
#Notebook02
0 0 0 3 14 4 0 3 39 44 13 0 0 0 0 4 12 4 0 0 0 1 10 4 0 0 27 38 10 0 0 0 0 1 10 6 
#Notebook01
0 0 0 4 11 4 0 2 44 42 12 0 0 0 0 3 11 6 0 0 0 0 12 5 0 0 28 37 9 0 0 0 0 0 10 6 
#Desk
0 0 0 5 9 5 5 21 31 13 0 0 0 0 0 6 8 8 0 0 0 9 8 8 8 25 35 12 0 0 0 0 0 8 13 8 
#Cup
0 0 0 12 17 3 0 0 34 36 3 0 0 0 0 1 10 19 0 0 0 2 12 18 0 0 37 20 0 0 0 0 0 10 6 7 
#Chair09
0 0 0 2 9 7 0 12 45 31 1 0 0 0 0 6 8 8 0 0 0 4 8 7 0 13 45 27 0 0 0 0 0 2 8 4 
#Chair08
0 0 0 1 11 5 0 13 45 32 1 0 0 0 0 6 7 7 0 0 0 3 7 8 0 10 45 27 1 0 0 0 0 1 8 6 
#Chair07
0 0 0 2 10 5 0 16 45 26 0 0 0 0 0 5 7 8 0 0 0 6 8 9 0 14 43 28 1 0 0 0 0 2 7 4 
#Chair06
0 0 0 3 12 7 0 14 39 27 1 0 0 0 0 5 8 8 0 0 0 7 7 9 0 12 43 28 1 0 0 0 0 3 9 5 
#Chair05
0 0 0 2 11 6 0 13 41 26 0 0 0 0 0 5 10 9 0 0 0 4 8 9 0 13 46 27 1 0 0 0 0 2 7 5 
#Chair04
0 0 0 2 11 6 0 13 40 31 1 0 0 0 0 6 9 7 0 0 0 5 7 9 0 12 39 30 0 0 0 0 0 2 10 6 
#Chair03
0 0 0 2 9 5 0 11 43 30 0 0 0 0 0 5 7 9 0 0 0 5 8 8 0 14 46 29 0 0 0 0 0 1 8 5 
#Chair02
0 0 0 2 13 7 0 13 46 29 1 0 0 0 0 5 7 7 0 0 0 6 9 7 0 12 40 27 0 0 0 0 0 2 7 5 
#Chair01
0 0 0 2 12 6 0 15 43 26 1 0 0 0 0 6 9 7 0 0 0 6 11 9 0 14 38 27 0 0 0 0 0 2 8 4 
#CellingLight04
0 0 0 2 9 18 3 8 15 14 12 17 0 0 0 3 7 13 0 0 0 2 8 18 3 8 17 13 11 18 0 0 0 2 8 15 
#CellingLight03
0 0 0 3 8 16 2 9 18 12 12 17 0 0 0 2 8 14 0 0 0 4 6 17 2 9 15 13 13 16 0 0 0 3 8 15 
#CellingLight02
0 0 0 4 9 17 2 10 16 14 11 16 0 0 0 3 7 15 0 0 0 2 7 17 2 9 15 13 12 16 0 0 0 2 8 15 
#CellingLight01
0 0 0 2 8 17 2 10 16 13 12 17 0 0 0 3 6 17 0 0 0 2 7 15 2 9 13 13 13 20 0 0 0 4 7 15 
#Book
0 0 0 6 13 5 5 21 29 14 0 0 0 0 0 7 12 7 0 0 0 8 14 8 7 18 33 14 0 0 0 0 0 6 13 5 
