#TV02
21 46 53 47 33 23 16 9 3 0 
#TV01
20 46 53 47 33 23 16 10 4 0 
#Screen
13 34 45 48 45 36 21 9 2 0 
#Projector
6 24 40 50 49 39 23 13 6 0 
#Notebook02
12 33 45 51 48 36 19 6 1 0 
#Notebook01
12 33 46 51 48 36 19 6 1 0 
#Desk
16 41 62 46 34 24 17 9 4 0 
#Cup
6 20 37 54 56 33 22 18 3 1 
#Chair09
11 30 52 59 48 29 14 6 2 0 
#Chair08
11 30 52 59 47 30 14 6 2 0 
#Chair07
11 31 53 58 46 30 14 6 2 0 
#Chair06
11 30 52 57 45 30 16 7 2 0 
#Chair05
11 30 52 57 46 30 16 7 2 0 
#Chair04
11 29 52 57 46 31 16 7 2 0 
#Chair03
11 30 52 58 47 30 15 6 2 0 
#Chair02
11 30 52 57 47 30 15 7 2 0 
#Chair01
11 30 51 57 46 31 16 7 2 0 
#CellingLight04
8 22 31 37 38 36 31 25 16 6 
#CellingLight03
8 22 32 37 38 37 32 24 15 6 
#CellingLight02
8 22 32 37 39 37 31 24 15 6 
#CellingLight01
8 22 31 37 38 37 31 25 17 7 
#Book
15 39 50 49 40 27 18 11 3 0 
