#Desk
0 0 0 11 11 5 0 22 29 21 1 0 0 0 0 11 11 6 0 0 0 11 9 4 0 21 29 18 1 0 0 0 0 10 11 6 
#Chair09
0 0 0 4 4 8 0 24 47 8 1 0 0 0 0 5 7 12 0 0 0 7 8 9 1 23 49 8 1 0 0 0 0 6 4 8 
#Chair08
0 0 0 4 2 9 2 23 50 8 0 0 0 0 0 5 9 12 0 0 0 5 8 9 1 22 49 7 1 0 0 0 0 6 5 7 
#Chair07
0 0 0 4 3 8 1 22 51 9 1 0 0 0 0 4 9 11 0 0 0 6 7 8 1 23 49 6 1 0 0 0 0 5 4 9 
#Chair06
0 0 0 3 3 9 1 22 52 8 1 0 0 0 0 6 7 13 0 0 0 5 9 8 0 22 49 7 1 0 0 0 0 6 3 9 
#Chair05
0 0 0 4 3 9 2 22 49 8 1 0 0 0 0 5 7 10 0 0 0 5 9 10 2 25 47 8 1 0 0 0 0 5 4 9 
#Chair04
0 0 0 4 4 8 2 23 52 9 1 0 0 0 0 5 9 9 0 0 0 6 9 9 2 19 48 10 1 0 0 0 0 5 3 8 
#Chair03
0 0 0 5 3 7 2 20 48 9 1 0 0 0 0 4 8 11 0 0 0 6 7 12 1 23 49 9 1 0 0 0 0 5 5 8 
#Chair020
0 0 0 3 4 8 1 21 54 8 1 0 0 0 0 5 8 9 0 0 0 4 7 10 0 26 47 8 1 0 0 0 0 4 4 8 
#Chair02
0 0 0 5 3 9 1 24 47 7 1 0 0 0 0 5 9 9 0 0 0 4 8 10 1 24 50 9 1 0 0 0 0 4 4 8 
#Chair019
0 0 0 6 2 8 1 22 50 10 0 0 0 0 0 5 10 10 0 0 0 7 8 11 1 19 51 7 1 0 0 0 0 5 3 9 
#Chair018
0 0 0 6 2 6 1 25 48 9 0 0 0 0 0 4 10 11 0 0 0 6 11 9 1 21 49 8 0 0 0 0 0 5 5 7 
#Chair017
0 0 0 4 3 8 2 23 51 8 0 0 0 0 0 6 6 10 0 0 0 7 8 11 1 22 50 7 1 0 0 0 0 4 4 8 
#Chair016
0 0 0 5 2 8 0 23 48 7 1 0 0 0 0 6 9 12 0 0 0 6 9 12 1 24 48 9 0 0 0 0 0 4 3 6 
#Chair015
0 0 0 5 3 8 1 23 48 7 1 0 0 0 0 4 11 10 0 0 0 6 8 10 1 23 51 8 1 0 0 0 0 4 4 8 
#Chair014
0 0 0 4 3 7 0 26 50 8 1 1 0 0 0 6 10 11 0 0 0 4 6 9 2 23 49 8 0 0 0 0 0 5 3 8 
#Chair013
0 0 0 5 3 9 1 22 47 8 1 0 0 0 0 7 8 11 0 0 0 5 9 9 1 22 51 8 1 0 0 0 0 7 3 7 
#Chair012
0 0 0 5 3 7 1 20 52 7 1 0 0 0 0 6 9 13 0 0 0 6 8 9 1 19 53 8 0 0 0 0 0 4 4 7 
#Chair011
0 0 0 4 3 9 1 21 50 7 1 0 0 0 0 4 12 10 0 0 0 5 10 12 1 23 46 8 1 0 0 0 0 4 3 8 
#Chair010
0 0 0 4 3 7 1 24 48 9 1 1 0 0 0 6 11 11 0 0 0 4 10 10 2 22 48 9 1 0 0 0 0 5 3 6 
#Chair01
0 0 0 5 3 7 2 23 51 8 1 0 0 0 0 5 7 8 0 0 0 5 10 12 1 22 48 8 1 0 0 0 0 7 4 8 
