#Desk
0 0 0 3 12 14 0 10 30 24 2 0 0 0 0 2 12 13 0 0 0 3 11 12 0 8 32 29 1 0 0 0 0 4 10 13 
#Chair06
0 0 0 0 6 5 2 14 35 26 21 2 0 0 0 4 5 4 0 0 0 3 7 6 2 16 32 26 16 2 0 0 0 0 5 4 
#Chair05
0 0 0 0 4 5 2 16 32 24 19 3 0 0 0 3 6 4 0 0 0 4 9 6 5 16 33 25 17 2 0 0 0 0 3 7 
#Chair04
0 0 0 0 4 4 3 14 31 26 21 3 0 0 0 3 6 5 0 0 0 3 8 5 3 14 32 27 19 4 0 0 0 0 3 6 
#Chair03
0 0 0 0 6 7 2 17 28 27 19 3 0 0 0 6 6 5 0 0 0 3 7 3 3 14 25 27 20 2 0 0 0 1 8 5 
#Chair02
0 0 0 0 4 6 3 13 29 29 20 3 0 0 0 3 7 3 0 0 0 4 7 4 2 16 32 26 19 3 0 0 0 0 4 4 
#Chair01
0 0 0 0 1 8 1 15 33 35 9 4 0 0 0 2 7 4 0 0 0 3 8 5 1 13 34 40 16 0 0 0 0 0 0 7 
