#Desk
15 37 48 48 39 27 19 12 6 0 
#Chair06
9 28 42 52 57 41 16 5 1 0 
#Chair05
9 28 43 53 56 39 16 5 1 0 
#Chair04
9 27 42 52 56 42 17 5 1 0 
#Chair03
8 26 39 51 57 42 19 6 2 0 
#Chair02
9 28 42 52 56 42 17 5 1 0 
#Chair01
9 28 42 53 57 41 16 5 1 0 
