#Desk
0 0 2 6 8 11 17 8 11 11 9 14 9 7 7 3 0 0 0 0 3 4 7 8 14 10 10 12 9 16 9 8 7 3 0 0 
#Chair06
0 0 0 2 4 11 2 21 33 6 14 8 5 6 4 2 0 0 0 0 2 5 5 7 7 14 6 37 20 4 10 4 2 1 0 0 
#Chair05
0 0 0 2 4 10 3 19 29 5 14 8 8 5 4 2 0 0 0 0 3 4 7 8 7 14 7 32 25 3 10 5 2 1 0 0 
#Chair04
0 0 1 2 4 11 3 20 32 5 15 6 5 5 3 4 0 0 0 0 4 4 6 7 7 14 4 35 22 3 10 5 3 0 0 0 
#Chair03
0 0 0 4 4 12 2 19 32 5 14 7 6 6 5 3 0 0 0 0 2 5 6 7 8 15 6 31 21 3 9 5 3 0 0 0 
#Chair02
0 0 0 2 3 11 3 18 31 6 15 6 8 4 4 2 0 0 0 0 3 4 7 7 8 14 7 35 19 4 11 5 3 1 0 0 
#Chair01
0 0 1 1 5 12 3 19 26 6 14 6 7 5 4 3 0 0 0 0 3 5 4 7 9 15 7 34 22 5 11 5 1 1 0 0 
