#Desk
13 35 51 51 38 27 20 11 5 0 
#Chair06
10 31 50 59 49 30 14 6 2 0 
#Chair05
10 31 49 59 50 30 14 6 2 0 
#Chair04
10 31 50 59 48 30 14 7 2 0 
#Chair03
10 30 48 59 49 31 15 7 2 0 
#Chair02
10 31 50 60 49 30 14 6 2 0 
#Chair01
10 30 49 59 49 31 15 7 2 0 
