#Desk
0 0 1 1 2 3 2 6 4 5 7 9 8 9 11 9 14 12 10 12 14 10 8 6 5 7 7 9 5 8 8 7 8 5 4 2 
#Chair06
0 0 0 1 3 3 6 6 6 7 10 10 14 13 10 9 11 12 8 9 9 10 10 15 7 6 4 3 5 4 5 4 8 6 5 3 
#Chair05
0 0 0 1 2 4 4 3 5 9 10 9 15 10 9 10 12 10 11 11 8 11 10 13 10 7 5 4 4 5 3 4 8 6 5 3 
#Chair04
0 0 0 1 3 4 4 4 6 10 9 11 12 11 11 9 14 9 6 7 11 11 10 10 11 6 4 4 3 4 4 5 10 7 4 4 
#Chair03
0 0 0 0 2 2 4 3 7 9 8 9 13 12 9 9 13 11 9 7 13 11 10 12 9 7 4 5 5 5 4 5 9 6 3 3 
#Chair02
0 0 0 0 1 6 5 4 6 10 7 12 12 10 10 8 12 12 10 10 12 9 8 15 9 7 4 5 4 3 4 4 8 7 3 3 
#Chair01
0 0 0 0 2 2 3 5 5 11 8 9 13 9 11 9 14 11 10 8 11 11 13 12 8 7 4 6 3 3 3 4 10 7 4 3 
