#Desk
0 2 2 4 9 12 10 9 11 12 10 10 10 9 3 4 1 0 0 2 2 3 9 11 8 10 12 14 10 11 11 8 4 3 1 0 
#Chair09
0 0 1 2 7 11 15 10 13 23 14 4 6 8 3 2 0 0 0 0 2 3 7 6 5 11 25 16 10 18 10 6 1 1 0 0 
#Chair08
0 1 1 2 6 12 17 12 14 22 15 4 7 7 3 1 0 0 0 0 1 5 7 7 4 12 23 13 9 18 8 6 2 1 1 0 
#Chair07
0 0 1 2 6 12 17 12 13 20 17 4 7 7 3 1 0 0 0 0 1 4 8 8 5 12 23 14 10 18 8 6 2 2 0 0 
#Chair06
0 0 1 2 6 12 12 16 16 25 12 4 7 6 2 2 0 0 0 0 1 2 8 7 4 16 21 15 17 12 9 5 1 2 0 0 
#Chair05
0 0 2 2 7 9 15 12 20 25 11 4 7 10 3 1 0 0 0 0 2 3 5 7 3 14 24 14 14 11 10 6 2 2 0 0 
#Chair04
0 0 1 1 6 10 14 10 19 25 13 4 7 7 2 0 0 0 0 0 2 3 8 5 4 15 23 15 9 14 12 6 1 2 1 0 
#Chair03
0 0 1 1 6 10 14 10 19 25 13 4 8 7 2 0 0 0 0 0 2 3 7 5 4 15 24 15 10 14 12 6 1 2 1 0 
#Chair02
0 0 1 2 6 8 16 11 16 24 13 6 7 7 3 2 0 0 0 0 1 3 6 6 4 15 28 13 12 15 11 7 2 1 0 0 
#Chair014
0 0 1 1 6 9 14 12 15 23 15 5 7 7 3 2 0 0 0 0 1 3 7 6 4 15 27 14 12 14 10 7 2 0 0 0 
#Chair013
0 1 2 1 8 10 13 11 18 24 12 4 6 6 4 1 0 0 0 0 1 3 7 5 5 14 24 15 12 13 9 6 2 2 1 0 
#Chair012
0 0 1 1 6 9 14 11 15 24 16 4 7 8 2 2 0 0 0 0 2 4 7 8 5 14 20 16 11 13 11 6 2 1 0 0 
#Chair011
0 0 2 1 5 12 14 10 15 19 15 4 8 6 4 3 0 0 0 0 2 2 8 7 4 14 25 17 12 14 9 7 1 1 0 0 
#Chair010
0 0 2 2 5 10 13 10 14 24 14 5 9 8 3 2 0 0 0 0 2 3 7 9 3 13 23 16 10 15 9 8 2 1 0 0 
#Chair01
0 0 2 3 6 9 13 12 17 23 13 4 8 8 3 2 0 0 0 0 3 3 7 8 5 14 21 14 12 12 11 4 3 1 0 0 
