#Desk
23 55 49 39 30 23 18 11 4 0 
#Chair09
8 20 35 59 51 40 25 11 3 0 
#Chair08
8 19 32 57 51 42 28 12 4 0 
#Chair07
8 19 33 57 51 42 28 11 4 0 
#Chair06
7 19 34 59 52 42 25 9 3 0 
#Chair05
7 18 32 57 52 43 27 11 4 0 
#Chair04
7 20 35 58 52 40 25 11 3 0 
#Chair03
7 20 35 59 52 40 25 10 3 0 
#Chair02
7 20 35 59 51 40 25 10 3 0 
#Chair014
7 20 35 59 52 40 25 10 3 0 
#Chair013
8 19 34 58 52 41 25 10 3 0 
#Chair012
7 19 34 56 52 41 26 11 4 0 
#Chair011
7 19 33 56 52 42 26 11 4 0 
#Chair010
7 19 34 56 51 42 26 11 3 0 
#Chair01
7 19 34 56 51 42 26 11 4 0 
