#Desk
0 0 0 16 15 4 3 14 19 8 0 0 0 0 0 17 16 6 0 0 0 17 17 4 2 18 19 8 0 0 0 0 0 20 17 4 
#Chair09
0 0 0 0 7 7 0 21 57 9 0 0 0 0 0 5 12 11 0 0 0 6 13 11 0 17 54 9 0 0 0 0 0 0 4 4 
#Chair08
0 0 0 0 7 6 0 21 60 10 0 0 0 0 0 7 12 8 0 0 0 5 13 9 0 15 56 9 0 0 0 0 0 0 4 4 
#Chair07
0 0 0 0 7 4 0 18 62 8 0 0 0 0 0 8 11 9 0 0 0 6 13 8 0 19 55 10 0 0 0 0 0 1 3 4 
#Chair06
0 0 0 0 6 8 0 17 62 8 0 0 0 0 0 5 15 7 0 0 0 6 14 9 0 15 57 9 0 0 0 0 0 0 4 4 
#Chair05
0 0 0 0 7 6 0 19 58 8 0 0 0 0 0 7 13 12 0 0 0 6 13 11 0 13 58 8 0 0 0 0 0 0 4 4 
#Chair04
0 0 0 0 7 6 0 17 59 9 0 0 0 0 0 6 13 9 0 0 0 6 11 9 0 17 58 9 0 0 0 0 0 0 5 5 
#Chair03
0 0 0 0 5 5 0 20 61 9 0 0 0 0 0 6 14 11 0 0 0 7 12 11 0 15 56 8 0 0 0 0 0 0 4 4 
#Chair02
0 0 0 0 8 5 0 23 57 9 0 0 0 0 0 5 15 10 0 0 0 4 12 9 0 16 55 9 0 0 0 0 0 0 4 3 
#Chair012
0 0 0 0 6 7 0 19 63 8 0 0 0 0 0 7 15 9 0 0 0 6 10 11 0 17 53 8 0 0 0 0 0 0 5 4 
#Chair011
0 0 0 0 6 5 0 21 59 7 0 0 0 0 0 6 14 10 0 0 0 6 12 11 0 14 60 9 0 0 0 0 0 0 4 3 
#Chair010
0 0 0 0 8 6 0 19 57 8 0 0 0 0 0 5 12 12 0 0 0 8 13 9 0 16 56 8 0 0 0 0 0 0 5 4 
#Chair01
0 0 0 0 6 6 0 17 59 9 0 0 0 0 0 7 14 11 0 0 0 6 12 10 0 16 58 8 0 0 0 0 0 0 5 4 
#CellingLight06
0 0 0 7 3 2 1 3 11 62 10 5 0 0 0 6 3 4 0 0 0 7 4 4 1 6 14 63 10 4 0 0 0 6 3 5 
#CellingLight05
0 0 0 6 4 4 0 4 12 65 9 5 0 0 0 7 3 3 0 0 0 6 3 4 1 5 13 63 9 6 0 0 0 4 4 3 
#CellingLight04
0 0 0 5 4 3 0 4 12 67 8 5 0 0 0 7 3 4 0 0 0 4 3 4 1 5 14 62 9 6 0 0 0 5 4 3 
#CellingLight03
0 0 0 6 3 5 1 6 15 64 10 4 0 0 0 7 4 4 0 0 0 5 3 4 1 3 11 63 10 5 0 0 0 7 3 2 
#CellingLight02
0 0 0 6 4 5 1 5 14 61 9 6 0 0 0 6 3 5 0 0 0 6 3 4 1 5 13 58 9 6 0 0 0 6 4 6 
#CellingLight01
0 0 0 6 4 5 1 5 15 60 8 5 0 0 0 6 4 6 0 0 0 7 4 4 1 4 12 59 9 5 0 0 0 6 3 5 
#Cabinet
0 0 0 2 12 9 0 13 19 24 8 0 0 0 0 2 13 9 0 0 0 2 13 10 1 16 25 29 10 0 0 0 0 3 13 12 
