#Desk
0 0 1 3 6 23 6 10 9 7 6 6 25 7 5 1 0 0 0 1 1 3 7 26 7 7 9 10 6 7 29 7 3 1 0 0 
#Chair09
0 0 1 1 4 6 2 20 24 18 13 9 8 8 6 5 0 0 0 1 6 7 8 8 9 13 14 23 18 1 5 1 1 0 0 0 
#Chair08
0 0 1 1 4 6 2 24 25 15 13 9 9 9 4 4 0 0 0 0 4 7 8 7 9 11 18 24 14 2 5 2 1 0 0 0 
#Chair07
0 0 0 0 6 4 3 20 27 16 14 8 9 8 6 5 0 0 0 0 4 6 8 8 10 13 13 23 22 2 4 1 1 0 0 0 
#Chair06
0 0 1 1 5 5 4 20 24 16 14 9 7 9 6 4 0 0 0 0 4 6 10 8 11 14 16 19 17 2 6 1 1 0 0 0 
#Chair05
0 1 1 1 4 5 3 20 24 16 12 9 9 9 6 7 0 0 0 0 5 7 9 7 9 12 16 23 16 2 5 1 1 0 0 0 
#Chair04
0 0 1 1 6 5 2 20 26 16 12 9 8 9 6 5 0 0 0 0 3 7 6 8 9 13 15 22 19 3 5 3 1 0 0 0 
#Chair03
0 0 0 1 3 5 2 19 24 19 15 9 8 9 7 5 0 0 0 0 6 6 7 8 9 13 16 20 17 3 4 2 1 0 0 0 
#Chair02
0 0 1 1 6 4 3 21 27 14 14 10 8 10 7 4 0 0 0 0 5 7 8 5 10 13 15 21 17 2 4 2 1 0 0 0 
#Chair012
0 0 1 1 5 5 2 21 27 18 13 9 9 9 6 5 0 0 0 0 6 6 6 8 9 12 15 23 16 2 5 2 2 0 0 0 
#Chair011
0 0 1 0 4 4 3 18 26 17 15 7 8 10 5 6 0 0 0 0 5 7 7 8 9 16 15 23 17 3 5 1 1 0 0 0 
#Chair010
0 0 1 1 5 5 2 19 24 17 14 8 8 8 7 6 0 0 0 0 5 5 9 9 9 13 16 22 17 3 6 3 1 0 0 0 
#Chair01
0 0 0 1 4 5 3 19 23 18 14 8 8 9 8 5 0 0 0 0 5 6 7 8 8 13 15 24 19 3 6 3 2 0 0 0 
#CellingLight06
0 0 0 0 2 9 14 14 18 16 15 14 8 3 2 0 0 0 0 0 0 2 2 9 14 15 18 18 16 16 7 2 2 1 0 0 
#CellingLight05
0 0 1 1 3 8 14 18 18 17 15 13 10 2 1 1 0 0 0 0 0 1 2 8 16 15 16 18 19 14 7 3 1 0 0 0 
#CellingLight04
0 0 0 0 4 7 17 17 18 16 15 15 8 3 2 1 0 0 0 0 0 2 2 8 17 14 17 18 19 13 7 3 1 0 0 0 
#CellingLight03
0 0 1 2 2 7 17 16 18 17 15 15 9 2 2 0 0 0 0 0 0 2 3 7 14 16 16 19 13 14 9 2 1 0 0 0 
#CellingLight02
0 0 1 2 2 8 15 17 15 18 16 15 9 2 2 1 0 0 0 0 0 1 2 8 15 16 15 16 15 15 9 3 1 1 0 0 
#CellingLight01
0 0 1 1 4 8 14 17 18 16 16 13 9 3 3 1 0 0 0 0 0 2 3 9 14 16 15 16 14 15 8 2 2 1 0 0 
#Cabinet
0 0 0 4 12 6 8 18 8 7 17 6 7 15 3 0 0 0 0 0 0 4 13 9 7 23 9 9 23 9 8 17 3 0 0 0 
