#Picture04
0 0 0 6 14 8 3 11 17 20 11 0 0 0 0 5 14 9 0 0 0 4 11 11 4 12 22 23 11 0 0 0 0 4 16 9 
#Picture03
0 0 0 6 15 9 5 17 31 13 0 0 0 0 0 6 12 9 0 0 0 6 13 9 4 21 31 11 0 0 0 0 0 8 11 8 
#Picture02
0 0 0 7 11 8 3 11 23 37 9 0 0 0 0 6 11 8 0 0 0 5 9 3 4 14 23 25 11 0 0 0 0 5 8 4 
#Picture01
0 0 0 4 14 6 5 13 24 27 7 0 0 0 0 4 14 7 0 0 0 4 14 6 4 13 20 24 5 0 0 0 0 5 13 10 
#Desk
0 0 0 13 13 4 14 28 24 4 0 0 0 0 0 11 10 6 0 0 0 14 12 6 11 25 21 4 0 0 0 0 0 11 11 6 
#Chair09
0 0 0 3 9 8 4 14 23 21 6 0 0 0 0 8 11 18 0 0 0 9 14 16 3 10 21 20 8 0 0 0 0 3 9 7 
#Chair08
0 0 0 2 11 7 4 12 20 19 7 0 0 0 0 8 14 18 0 0 0 9 12 17 5 14 22 19 6 0 0 0 0 1 9 7 
#Chair07
0 0 0 1 10 7 4 14 20 20 6 0 0 0 0 6 15 19 0 0 0 10 15 18 5 13 20 19 7 0 0 0 0 1 10 7 
#Chair06
0 0 0 2 9 8 4 12 17 21 6 0 0 0 0 11 12 19 0 0 0 10 13 18 5 13 23 16 7 0 0 0 0 2 9 8 
#Chair05
0 0 0 1 10 11 5 13 21 17 7 0 0 0 0 10 14 18 0 0 0 10 12 18 4 11 20 19 6 0 0 0 0 2 10 7 
#Chair04
0 0 0 1 10 11 5 12 21 17 7 0 0 0 0 10 14 18 0 0 0 10 11 18 4 10 20 19 5 0 0 0 0 2 10 7 
#Chair03
0 0 0 1 11 7 4 14 20 21 5 0 0 0 0 8 12 20 0 0 0 9 13 17 5 13 22 20 7 0 0 0 0 2 9 6 
#Chair02
0 0 0 2 11 7 6 13 20 21 6 0 0 0 0 8 13 15 0 0 0 9 12 18 4 15 23 20 7 0 0 0 0 2 8 6 
#Chair014
0 0 0 3 8 5 6 15 24 20 6 0 0 0 0 9 12 18 0 0 0 10 12 18 4 12 20 18 6 0 0 0 0 1 10 7 
#Chair013
0 0 0 2 9 7 5 15 22 20 6 0 0 0 0 7 13 20 0 0 0 8 16 17 4 12 17 20 7 0 0 0 0 2 8 8 
#Chair012
0 0 0 2 11 7 4 12 19 21 5 0 0 0 0 8 14 18 0 0 0 8 14 19 4 14 18 22 6 0 0 0 0 2 10 5 
#Chair011
0 0 0 2 11 7 4 12 20 21 5 0 0 0 0 8 14 19 0 0 0 8 13 19 5 14 18 23 7 0 0 0 0 2 10 5 
#Chair010
0 0 0 3 11 7 4 13 19 21 7 0 0 0 0 8 13 16 0 0 0 9 14 17 4 13 21 21 6 0 0 0 0 2 9 7 
#Chair01
0 0 0 2 11 8 4 12 21 20 7 0 0 0 0 9 13 20 0 0 0 7 12 17 6 14 18 18 7 0 0 0 0 3 10 5 
#CellingLight04
0 0 0 4 7 13 2 10 17 17 12 19 0 0 0 4 7 15 0 0 0 4 7 16 2 9 16 13 11 16 0 0 0 3 5 16 
#CellingLight03
0 0 0 3 7 17 3 8 18 16 13 16 0 0 0 3 7 14 0 0 0 4 6 14 2 9 15 13 16 15 0 0 0 3 8 15 
#CellingLight02
0 0 0 3 7 17 3 8 18 16 14 16 0 0 0 3 7 15 0 0 0 4 6 16 2 9 14 12 15 15 0 0 0 3 8 14 
#CellingLight01
0 0 0 3 9 13 2 9 16 14 13 17 0 0 0 3 6 17 0 0 0 3 7 17 2 10 15 15 10 15 0 0 0 2 8 16 
#Bonsai03
0 0 0 3 7 3 3 10 12 12 5 0 0 0 0 13 29 16 0 0 0 11 42 22 0 9 14 12 8 1 0 0 0 1 8 3 
#Bonsai02
0 0 0 1 7 4 2 13 14 12 5 0 0 0 0 12 26 16 0 0 0 12 43 24 1 6 16 13 6 1 0 0 0 2 8 2 
#Bonsai01
0 0 0 2 6 4 2 12 14 12 5 0 0 0 0 12 26 15 0 0 0 12 44 24 1 6 16 13 6 1 0 0 0 2 8 2 
