#Picture04
12 28 38 43 43 38 29 17 4 0 
#Picture03
16 38 48 48 38 27 19 12 5 0 
#Picture02
14 32 42 45 45 39 24 9 2 0 
#Picture01
12 31 41 45 44 37 24 14 4 0 
#Desk
22 55 50 40 30 22 17 10 3 0 
#Chair09
9 22 39 52 53 38 21 13 4 0 
#Chair08
9 23 39 53 53 36 20 13 4 0 
#Chair07
9 22 39 52 53 37 21 13 5 0 
#Chair06
9 22 39 52 52 37 21 13 5 1 
#Chair05
9 22 38 52 52 36 21 14 5 1 
#Chair04
9 22 39 52 52 36 21 14 5 1 
#Chair03
9 23 40 53 53 37 20 12 4 0 
#Chair02
9 23 40 54 54 36 19 11 4 0 
#Chair014
9 23 40 55 53 36 20 11 4 0 
#Chair013
9 22 39 51 54 38 21 13 5 1 
#Chair012
9 22 39 52 52 38 22 13 4 0 
#Chair011
9 22 39 53 53 38 22 13 4 0 
#Chair010
9 23 39 52 53 37 20 12 4 0 
#Chair01
9 23 39 52 53 37 21 13 5 0 
#CellingLight04
8 22 32 38 39 37 31 23 14 6 
#CellingLight03
8 22 32 37 38 37 32 24 15 6 
#CellingLight02
8 22 31 37 38 37 32 24 15 6 
#CellingLight01
8 22 31 37 38 37 32 24 16 7 
#Bonsai03
15 44 38 25 44 42 24 12 5 1 
#Bonsai02
15 45 39 26 44 42 24 12 5 1 
#Bonsai01
15 45 39 26 44 41 23 12 5 1 
