#Desk
16 41 64 51 37 23 13 5 1 0 
#Chair09
12 34 52 57 51 25 11 7 3 0 
#Chair08
11 33 51 56 51 26 11 8 3 0 
#Chair07
11 33 50 55 53 27 11 7 3 0 
#Chair06
11 33 50 56 53 27 11 7 3 0 
#Chair05
12 34 52 56 51 25 11 7 3 0 
#Chair04
12 35 53 54 51 26 11 7 3 0 
#Chair03
12 33 51 56 52 26 11 7 3 0 
#Chair02
12 33 51 56 51 26 11 8 3 0 
#Chair012
12 34 52 56 52 26 11 7 3 0 
#Chair011
11 33 50 56 52 26 11 8 3 0 
#Chair010
11 33 51 55 52 26 11 7 4 0 
#Chair01
11 33 51 56 52 27 11 7 3 0 
#CellPhone
8 32 43 45 43 31 22 15 10 3 
#Book03
14 35 47 50 44 32 19 9 2 0 
#Book02
14 36 47 49 44 32 19 9 2 0 
#Book01
14 36 46 49 44 32 19 10 2 0 
