#Sofa03
30 57 42 36 30 21 16 11 6 1 
#Sofa02
8 31 48 54 38 29 20 15 7 0 
#Sofa01
8 30 48 54 38 29 20 15 8 0 
#Chair02
9 17 22 28 37 61 38 31 8 0 
#Chair01
9 17 22 27 36 62 39 31 8 0 
#Carpet
20 46 52 42 31 25 18 12 6 0 
#Bonsai
6 16 34 53 54 50 26 9 3 0 
