#Sofa03
0 1 3 8 13 8 9 8 7 6 7 8 9 7 7 6 7 7 7 5 6 7 8 8 7 8 7 6 5 6 6 11 6 8 1 3 
#Sofa02
0 0 0 0 0 0 1 2 4 6 6 11 10 12 12 10 9 8 8 11 6 9 6 8 8 8 12 12 9 5 13 11 9 7 4 1 
#Sofa01
0 0 0 0 0 0 1 3 3 6 8 9 11 11 11 12 9 9 7 11 6 9 6 7 8 7 11 14 10 5 13 12 9 7 4 1 
#Chair02
0 0 0 0 0 0 0 0 0 0 0 0 0 0 0 0 0 0 0 0 1 5 7 9 16 20 26 31 36 34 20 18 9 9 4 1 
#Chair01
0 0 0 0 0 0 0 0 0 0 0 0 0 0 0 0 0 0 0 0 1 6 7 7 15 19 23 32 38 32 22 19 13 9 5 1 
#Carpet
0 1 1 4 2 6 5 5 9 9 8 11 13 9 9 8 6 7 9 8 9 7 9 8 8 7 8 7 8 7 10 7 7 7 3 1 
#Bonsai
0 0 1 0 0 0 0 1 0 1 2 2 2 3 4 6 8 10 12 18 19 17 15 15 14 20 24 12 7 4 5 4 2 2 6 6 
