#Sofa03
0 0 4 6 9 10 9 11 10 15 14 11 9 9 6 5 0 0 0 1 7 5 7 8 9 9 13 13 7 7 8 6 4 6 0 0 
#Sofa02
0 0 2 7 12 8 13 14 12 11 14 11 9 13 8 3 0 0 0 0 2 10 9 7 7 12 9 8 10 7 7 8 8 3 0 0 
#Sofa01
0 0 2 7 12 7 11 16 11 11 13 11 10 12 8 3 0 0 0 0 2 10 9 8 7 11 9 7 12 7 7 9 8 3 0 0 
#Chair02
0 0 0 0 0 29 23 7 9 7 8 20 24 0 0 0 0 0 0 0 0 0 0 25 19 7 7 8 7 23 26 0 0 0 0 0 
#Chair01
0 0 0 0 0 26 24 7 7 8 6 19 32 0 0 0 0 0 0 0 0 0 0 23 24 8 7 7 6 16 29 0 0 0 0 0 
#Carpet
0 0 4 7 8 10 11 11 10 13 13 9 11 9 7 4 0 0 0 0 3 7 8 9 11 11 10 10 11 8 11 7 7 4 0 0 
#Bonsai
0 0 1 3 8 8 9 14 16 15 13 18 4 4 2 1 0 0 0 2 6 5 3 5 12 23 7 22 18 1 15 6 0 0 0 0 
