#Screen
16 33 43 47 45 34 20 11 2 0 
#Projector
5 16 28 37 40 44 43 27 9 0 
#Lamp02
28 83 51 5 4 5 4 18 32 22 
#Lamp01
28 82 51 6 4 5 4 18 32 22 
#Desk
18 40 48 38 29 25 20 16 11 6 
#Chair09
17 47 68 57 34 17 9 3 0 0 
#Chair08
17 45 68 59 35 17 8 3 0 0 
#Chair07
17 46 69 58 34 16 8 2 1 0 
#Chair06
17 46 70 59 34 16 8 2 0 0 
#Chair05
17 45 68 60 35 16 9 2 0 0 
#Chair04
16 44 66 57 35 18 10 3 1 0 
#Chair03
17 45 69 59 34 16 8 3 1 0 
#Chair02
17 45 67 57 35 17 9 3 1 0 
#Chair016
17 46 68 58 35 16 9 2 0 0 
#Chair015
17 47 69 59 34 16 8 2 0 0 
#Chair014
17 46 68 58 35 17 8 2 0 0 
#Chair013
17 46 68 58 34 17 8 2 0 0 
#Chair012
17 44 67 59 35 17 9 3 1 0 
#Chair011
16 45 68 59 34 17 9 3 1 0 
#Chair010
16 44 68 60 34 17 9 3 1 0 
#Chair01
16 43 67 60 36 18 9 3 1 0 
