#Screen
0 0 0 8 12 11 15 16 18 13 16 15 14 13 5 0 0 0 0 0 0 3 6 8 10 9 10 8 10 8 8 5 3 0 0 0 
#Projector
0 0 0 0 19 8 12 16 9 8 7 9 5 10 12 0 0 0 0 0 0 9 14 9 9 8 9 10 14 17 11 14 4 0 0 0 
#Lamp02
0 8 17 21 26 20 0 0 0 1 1 0 0 0 0 13 9 0 0 7 14 0 0 1 1 1 0 1 0 0 25 25 22 17 10 0 
#Lamp01
0 9 18 22 24 19 0 1 1 1 1 0 0 0 0 13 8 0 0 8 14 0 0 1 1 1 0 0 0 0 25 26 20 17 10 0 
#Desk
0 4 6 6 7 7 10 10 10 8 10 8 9 6 9 9 3 0 0 3 9 8 6 8 9 6 10 8 11 8 9 7 7 6 5 0 
#Chair09
0 2 2 3 3 7 10 9 30 11 19 17 4 2 1 0 0 0 0 0 0 0 2 4 13 22 11 26 12 9 10 3 3 2 1 0 
#Chair08
0 2 2 3 2 8 8 9 26 10 19 16 3 4 0 0 0 0 0 1 0 1 2 5 19 23 11 28 12 10 10 2 2 1 1 0 
#Chair07
0 1 2 3 3 8 8 10 23 11 20 14 4 3 1 0 0 0 0 0 0 1 4 7 16 23 12 29 15 10 7 2 2 1 1 0 
#Chair06
0 2 1 4 3 7 9 10 30 9 22 16 6 3 1 0 0 0 0 0 0 1 2 5 18 23 12 23 12 9 7 2 2 1 1 0 
#Chair05
0 1 2 3 2 8 10 9 25 12 19 17 4 1 2 0 0 0 0 0 0 1 4 5 19 23 11 28 12 8 7 3 2 1 2 0 
#Chair04
0 2 3 3 4 8 8 11 24 10 19 14 5 4 2 0 0 0 0 0 0 1 3 5 14 23 13 25 14 9 9 3 3 2 2 0 
#Chair03
0 1 2 3 3 7 9 12 28 10 17 16 6 3 1 0 0 0 0 0 0 1 3 6 16 25 10 26 11 9 8 2 2 1 2 0 
#Chair02
0 2 3 2 2 8 11 12 26 11 18 16 7 3 1 0 0 0 0 0 0 1 3 3 17 20 10 27 13 9 7 1 4 1 1 0 
#Chair016
0 2 2 3 3 8 9 11 27 9 22 15 5 2 0 0 0 0 0 0 0 1 3 4 17 25 9 27 12 9 8 2 2 2 2 0 
#Chair015
0 2 2 2 3 7 7 13 27 10 20 19 5 2 1 0 0 0 0 0 0 1 4 5 16 24 12 28 9 9 8 2 3 1 1 0 
#Chair014
0 2 1 2 4 8 8 12 28 11 19 16 6 3 0 0 0 0 0 0 0 1 3 4 17 25 9 25 12 10 8 3 3 1 1 0 
#Chair013
0 1 2 3 3 7 9 10 25 12 21 19 3 2 0 0 0 0 0 0 0 1 3 5 15 21 11 29 13 10 9 3 2 1 2 0 
#Chair012
0 2 2 2 3 7 10 11 26 8 20 19 5 3 0 0 0 0 0 0 0 1 4 5 16 23 9 27 14 8 7 2 2 2 1 0 
#Chair011
0 2 2 4 2 7 6 10 25 10 23 16 5 3 1 1 0 0 0 0 0 1 2 5 17 22 11 29 13 10 7 1 2 1 2 0 
#Chair010
0 2 2 2 2 6 8 11 25 10 21 14 5 3 0 0 1 0 0 0 0 1 3 4 18 21 12 28 14 10 8 2 2 1 2 0 
#Chair01
0 0 1 4 3 8 8 11 26 10 20 17 5 3 1 0 0 0 0 0 0 1 4 4 19 23 9 25 14 9 6 3 3 2 1 0 
