#Screen
0 0 0 1 1 2 2 2 5 5 5 3 5 6 6 10 12 16 16 15 12 10 11 11 10 10 10 9 11 8 7 4 6 4 3 0 
#Projector
0 0 0 0 0 0 0 1 1 1 1 2 2 2 4 5 4 3 4 4 5 6 8 13 14 17 13 12 27 25 17 13 12 12 8 2 
#Lamp02
0 0 0 0 0 0 0 1 0 0 0 0 0 1 0 0 0 0 0 0 0 7 15 14 13 12 13 14 13 13 13 13 16 29 33 18 
#Lamp01
0 0 0 0 0 0 0 1 0 0 0 0 0 0 0 0 0 0 0 0 0 7 15 14 13 12 12 13 12 13 13 12 16 30 33 18 
#Desk
0 0 0 2 3 5 4 6 6 7 7 9 8 8 8 7 8 8 6 5 7 7 8 5 5 8 6 5 6 7 6 7 11 14 17 14 
#Chair09
0 0 0 0 0 0 3 8 9 11 17 21 23 21 20 14 11 9 8 7 7 8 8 4 5 3 1 2 2 3 3 3 3 2 2 2 
#Chair08
0 0 0 0 0 0 3 7 9 10 17 19 24 23 22 14 12 10 8 7 8 8 7 6 4 2 2 3 2 2 3 3 1 2 3 2 
#Chair07
0 0 0 0 0 0 2 7 12 9 16 19 23 23 22 19 9 9 6 6 7 8 6 4 5 3 2 3 3 3 2 4 2 3 2 1 
#Chair06
0 0 0 0 0 0 3 8 8 11 17 22 20 25 23 17 10 7 8 8 7 7 7 5 4 3 2 2 3 2 3 3 2 1 2 2 
#Chair05
0 0 0 0 0 0 2 8 11 10 15 21 21 23 20 19 12 7 10 7 8 7 5 5 4 3 2 2 3 3 2 3 3 2 2 2 
#Chair04
0 0 0 0 0 0 1 9 8 11 15 19 23 23 20 17 10 10 6 6 9 7 6 4 6 2 3 4 3 2 3 4 3 3 3 2 
#Chair03
0 0 0 0 0 0 2 8 9 11 16 20 20 28 20 17 11 6 6 7 8 8 8 6 5 2 3 1 3 2 3 2 2 2 3 2 
#Chair02
0 0 0 0 0 0 3 7 12 11 17 19 19 23 20 16 10 9 8 7 8 8 7 5 3 2 1 2 3 4 3 3 4 2 3 2 
#Chair016
0 0 0 0 0 0 2 6 10 13 16 21 19 23 21 18 10 11 8 7 8 7 6 6 5 2 1 4 2 3 2 3 1 3 3 2 
#Chair015
0 0 0 0 0 0 2 9 9 12 16 21 22 21 21 18 10 9 7 8 6 8 9 6 3 2 2 2 3 2 2 3 2 2 2 1 
#Chair014
0 0 0 0 0 0 3 6 10 11 16 20 24 23 19 15 10 11 7 7 8 8 8 5 4 3 4 2 3 2 3 3 2 2 1 2 
#Chair013
0 0 0 0 0 0 3 6 10 12 18 18 23 25 19 17 11 8 8 8 7 6 8 3 4 3 2 2 2 1 3 3 3 1 2 2 
#Chair012
0 0 0 0 0 0 2 7 9 11 17 19 21 22 22 16 13 7 9 7 7 8 6 5 5 3 2 2 3 3 2 3 3 2 3 2 
#Chair011
0 0 0 0 0 0 2 6 11 13 16 19 22 23 23 18 9 8 6 7 8 6 8 4 4 2 1 3 3 4 3 2 2 4 2 3 
#Chair010
0 0 0 0 0 0 2 6 9 12 16 21 21 24 21 17 11 10 8 8 7 7 8 4 3 1 2 4 2 3 3 3 3 2 3 3 
#Chair01
0 0 0 0 0 0 1 8 11 11 12 20 19 25 23 18 10 9 8 8 7 7 9 4 3 4 3 2 4 5 3 3 3 2 1 1 
