#Speaker02
0 0 0 0 22 8 9 11 12 13 11 11 10 23 0 0 0 0 0 0 0 0 19 8 11 10 10 10 9 9 9 20 0 0 0 0 
#Speaker01
0 0 0 0 22 9 10 11 12 12 11 11 10 23 0 0 0 0 0 0 0 0 19 8 11 10 10 10 9 9 9 19 0 0 0 0 
#Screen
0 0 0 1 10 11 11 15 15 12 12 14 11 7 0 0 0 0 0 0 0 0 7 13 14 15 15 15 13 13 15 8 0 0 0 0 
#Projector
0 0 0 10 10 7 10 9 15 14 10 10 9 7 11 0 0 0 0 0 0 12 8 7 11 12 12 13 10 9 7 10 11 0 0 0 
#Notebook
0 0 0 0 7 13 16 15 10 14 17 13 12 9 0 0 0 0 0 0 0 1 7 12 14 12 9 15 16 15 10 7 0 0 0 0 
#DVDTray
0 0 0 6 9 10 10 11 13 13 10 15 9 9 6 0 0 0 0 0 0 5 7 12 12 12 14 12 13 11 10 9 6 0 0 0 
#DVD
0 0 0 7 11 12 12 9 12 13 12 9 10 7 10 0 0 0 0 0 0 10 7 10 10 10 11 11 11 12 10 7 11 0 0 0 
#Desk
0 1 2 3 8 15 7 6 12 13 7 13 12 10 3 2 1 0 0 1 2 3 10 17 14 9 15 11 8 8 13 8 3 3 1 0 
#Chair09
0 0 2 4 4 8 6 7 29 13 2 2 20 13 6 1 0 0 0 1 1 5 10 19 4 2 16 31 9 8 6 6 4 2 0 0 
#Chair08
0 0 2 3 6 7 8 7 29 13 3 3 21 12 6 1 0 0 0 0 1 5 9 20 3 2 15 33 8 7 6 6 3 2 0 0 
#Chair07
0 0 2 3 6 7 9 7 29 13 3 3 22 12 6 0 0 0 0 0 1 5 9 20 3 2 14 33 7 7 6 6 3 2 0 0 
#Chair06
0 0 3 2 8 8 7 9 28 15 2 2 19 12 7 0 0 0 0 0 1 5 12 19 3 3 14 32 8 7 6 5 3 3 0 0 
#Chair05
0 0 3 2 8 8 7 9 29 15 2 2 19 12 7 0 0 0 0 0 1 5 12 19 3 3 14 31 8 7 6 5 3 3 0 0 
#Chair04
0 0 3 2 8 8 7 9 29 14 2 2 19 12 7 0 0 0 0 0 1 5 12 19 3 2 14 31 8 7 7 5 3 2 0 0 
#Chair03
0 0 2 3 5 5 8 7 31 13 2 4 20 12 6 2 0 0 0 0 1 6 12 21 2 3 15 31 7 7 4 5 4 3 0 0 
#Chair02
0 0 2 3 5 6 8 8 31 13 3 4 20 12 6 1 0 0 0 0 1 6 12 20 2 3 14 30 7 7 4 5 4 2 0 0 
#Chair014
0 0 2 3 6 6 6 8 30 12 2 3 23 11 6 1 0 0 0 1 1 4 12 23 3 2 14 32 8 7 4 5 4 3 0 0 
#Chair013
0 0 2 3 5 5 8 7 31 13 2 4 20 13 6 1 0 0 0 0 1 6 12 21 2 3 14 31 7 7 4 5 4 3 0 0 
#Chair012
0 0 2 4 6 7 7 9 32 13 1 3 22 10 5 1 0 0 0 0 2 5 10 20 4 3 12 32 7 7 6 7 3 2 0 0 
#Chair011
0 0 2 4 7 7 6 7 28 13 2 2 18 11 7 2 0 0 0 0 1 4 11 19 4 2 16 33 8 8 6 5 3 5 0 0 
#Chair010
0 0 2 4 7 7 6 7 28 13 2 3 19 11 7 2 0 0 0 0 1 4 11 20 5 2 15 33 8 8 5 5 3 4 0 0 
#Chair01
0 0 2 3 6 7 7 7 31 16 2 3 18 12 7 1 0 0 0 0 2 7 10 21 2 2 15 28 10 6 6 5 3 2 0 0 
#Bookshelf02
0 3 4 3 6 13 12 10 16 10 10 14 4 4 5 2 4 0 0 2 1 5 6 9 14 11 13 17 9 12 7 3 2 4 3 0 
#Bookshelf01
0 3 4 3 7 13 11 11 16 10 10 14 4 4 5 2 4 0 0 2 1 5 6 10 14 11 13 18 9 11 7 3 2 4 3 0 
