#Speaker02
0 0 0 0 0 0 0 0 0 0 0 0 0 0 0 0 1 8 9 9 8 15 15 16 14 15 11 21 20 20 20 17 14 9 4 1 
#Speaker01
0 0 0 0 0 0 0 0 0 0 0 0 0 0 0 0 1 8 8 8 8 14 15 17 14 15 11 21 20 20 21 16 13 9 5 1 
#Screen
0 0 1 2 2 3 4 5 5 7 6 7 8 10 11 9 10 10 12 11 15 14 14 12 12 10 9 9 6 4 4 2 1 1 0 1 
#Projector
0 0 0 0 0 0 0 0 0 0 1 2 3 4 6 5 6 7 6 8 12 16 15 11 12 14 12 10 11 20 19 13 12 8 7 3 
#Notebook
0 0 0 0 0 0 0 0 0 0 0 0 0 0 7 15 13 16 19 18 17 17 16 22 17 17 14 11 11 6 3 3 2 2 0 0 
#DVDTray
0 0 1 2 2 2 4 4 6 4 5 6 8 9 9 6 11 9 10 10 13 13 13 10 10 8 9 9 9 10 8 6 4 4 2 2 
#DVD
0 0 0 0 0 0 3 3 3 4 4 3 5 5 5 6 8 7 9 11 9 17 15 12 12 10 10 9 14 16 12 10 8 5 4 3 
#Desk
0 1 3 5 6 6 7 7 9 10 8 6 6 7 6 6 8 9 11 9 11 12 13 10 11 12 8 6 4 3 4 3 4 4 3 2 
#Chair09
0 1 2 1 1 3 2 3 3 4 5 6 4 6 6 6 7 8 11 8 9 13 12 11 14 13 10 9 5 7 9 7 8 8 8 7 
#Chair08
0 1 1 2 1 3 3 4 4 4 4 7 5 6 7 6 7 8 9 8 10 13 11 10 14 13 12 9 4 7 8 7 7 8 9 7 
#Chair07
0 1 1 2 1 3 3 4 4 4 4 7 5 6 7 6 7 8 9 8 10 13 11 10 13 13 11 9 5 8 8 7 6 8 9 7 
#Chair06
0 0 1 2 1 2 3 2 4 5 5 7 5 5 6 7 7 8 10 7 9 13 11 14 13 14 11 7 7 7 6 7 9 8 8 8 
#Chair05
0 0 1 2 1 2 3 2 4 5 5 7 5 5 7 7 7 8 10 7 10 13 11 14 13 13 11 7 7 7 6 8 8 8 8 7 
#Chair04
0 0 1 2 1 2 3 2 4 5 5 7 5 6 6 7 6 8 10 7 9 13 11 14 14 14 11 7 7 7 6 7 8 9 8 7 
#Chair03
0 1 1 2 2 2 4 5 4 4 5 5 6 6 6 7 6 6 10 8 9 9 10 11 13 11 9 10 6 7 8 9 10 8 9 7 
#Chair02
0 1 1 2 2 2 4 5 4 4 4 5 6 5 6 7 6 6 10 8 9 9 10 11 14 11 9 10 6 7 8 10 9 8 9 7 
#Chair014
0 0 1 2 2 2 4 4 4 4 5 4 6 6 7 7 6 5 10 8 9 10 12 14 12 12 10 9 7 7 10 8 8 8 10 7 
#Chair013
0 1 1 2 2 2 4 5 4 4 5 5 6 6 6 7 6 6 10 8 9 9 10 11 14 11 9 10 6 7 8 9 10 8 9 7 
#Chair012
0 1 1 2 2 2 2 4 3 4 5 5 5 5 8 6 8 9 9 9 10 11 11 13 14 12 11 8 6 7 7 8 11 7 9 5 
#Chair011
0 1 2 2 2 3 3 3 3 5 5 5 4 5 5 7 7 7 9 10 11 13 9 10 12 13 11 8 7 8 6 7 6 8 11 8 
#Chair010
0 1 2 2 2 3 3 3 4 4 4 5 4 6 6 7 7 7 9 11 12 13 10 10 12 13 11 7 6 8 7 7 6 8 11 7 
#Chair01
0 1 1 1 1 2 3 4 5 4 4 8 4 6 6 9 6 7 11 8 9 11 10 12 12 13 12 7 7 7 8 7 8 8 8 7 
#Bookshelf02
0 0 0 1 1 9 15 15 12 9 8 8 7 10 8 7 8 12 17 11 7 6 6 4 4 6 5 3 4 4 3 8 3 6 5 10 
#Bookshelf01
0 0 0 1 1 9 15 15 12 9 8 8 7 10 8 7 8 12 16 11 7 6 6 4 4 6 4 3 4 3 3 8 3 6 5 10 
