#Speaker02
4 14 24 34 47 55 38 26 9 0 
#Speaker01
4 14 24 34 47 55 38 26 9 0 
#Screen
15 38 49 51 45 32 16 5 0 0 
#Projector
5 16 29 46 48 47 33 19 10 0 
#Notebook
11 32 45 50 49 39 20 6 0 0 
#DVDTray
12 34 44 48 44 34 21 11 3 0 
#DVD
6 25 41 45 44 40 28 16 6 0 
#Desk
22 56 50 39 28 24 19 10 3 0 
#Chair09
9 23 39 54 53 37 21 12 4 0 
#Chair08
9 23 40 54 53 37 20 12 4 0 
#Chair07
9 23 40 54 53 36 20 12 4 0 
#Chair06
9 23 38 52 53 38 21 12 4 0 
#Chair05
9 23 38 53 54 37 21 12 4 0 
#Chair04
9 23 39 53 53 37 21 13 4 0 
#Chair03
9 23 40 53 54 36 19 12 4 0 
#Chair02
9 22 40 53 54 36 20 12 4 0 
#Chair014
9 22 39 53 53 37 20 13 4 0 
#Chair013
9 22 40 53 54 36 19 12 4 0 
#Chair012
9 23 39 54 53 36 21 12 4 0 
#Chair011
9 23 39 53 53 36 20 13 5 1 
#Chair010
9 23 39 53 53 36 20 12 4 0 
#Chair01
9 22 40 53 54 37 20 12 4 0 
#Bookshelf02
18 55 57 38 32 22 15 9 4 1 
#Bookshelf01
18 55 57 38 32 22 15 9 4 1 
