#Desk
0 1 1 4 6 7 9 9 12 11 9 8 7 6 2 2 1 0 0 0 2 3 5 6 11 20 30 26 19 11 6 3 2 1 0 0 
#Chair08
0 0 0 2 5 7 3 6 20 21 19 15 8 6 3 5 1 0 0 1 3 4 6 8 15 16 25 23 4 1 5 4 2 1 0 0 
#Chair07
0 0 0 2 5 7 3 6 21 21 19 14 8 6 3 5 1 0 0 1 3 4 6 9 15 16 25 24 4 1 5 4 2 1 0 0 
#Chair06
0 0 0 5 6 7 3 5 22 25 12 14 8 5 4 5 0 0 0 0 3 6 5 6 13 15 27 23 5 1 6 5 4 0 0 0 
#Chair05
0 0 0 3 6 5 2 4 23 26 18 17 8 5 5 4 1 0 0 0 4 4 5 8 13 17 26 20 4 2 4 4 3 1 0 0 
#Chair04
0 0 0 3 6 4 1 5 20 28 23 13 7 6 4 3 1 0 0 0 3 3 6 8 13 16 23 21 6 1 6 5 4 0 0 0 
#Chair03
0 0 0 4 6 5 1 5 21 28 22 14 6 6 4 3 1 0 0 0 2 3 6 8 13 16 23 22 6 2 6 4 5 1 0 0 
#Chair02
0 0 0 3 5 7 1 3 19 25 17 16 6 7 6 3 0 0 0 0 4 5 6 8 14 15 25 23 4 1 8 6 3 0 0 0 
#Chair01
0 0 0 3 4 6 1 5 20 26 17 15 8 7 5 3 1 0 0 0 3 5 7 6 13 20 23 20 5 2 5 5 4 1 0 0 
#CellPhone
0 0 8 5 7 9 8 10 13 11 10 11 9 7 6 7 0 0 0 0 8 6 8 8 11 10 11 11 10 11 8 8 5 7 0 0 
#Book02
0 0 0 4 9 13 11 12 12 13 13 12 10 9 4 0 0 0 0 0 0 3 9 10 12 12 13 12 13 12 11 8 4 0 0 0 
#Book01
0 0 0 4 8 11 12 13 15 15 12 9 10 9 3 0 0 0 0 0 0 4 9 9 13 14 13 14 13 13 13 7 3 0 0 0 
