#Desk
0 0 0 5 10 4 6 18 26 9 0 0 0 0 0 6 8 4 0 0 0 5 7 5 9 27 40 24 18 0 0 0 0 5 5 4 
#Chair08
0 0 0 1 2 12 5 14 43 22 0 0 0 0 0 7 9 8 0 0 0 7 8 8 6 17 37 26 1 0 0 0 0 1 1 11 
#Chair07
0 0 0 1 2 12 5 14 43 22 0 0 0 0 0 7 9 8 0 0 0 8 8 7 6 17 37 25 1 0 0 0 0 1 1 11 
#Chair06
0 0 0 1 2 16 5 17 38 21 0 0 0 0 0 7 8 9 0 0 0 5 8 8 5 19 39 22 1 0 0 0 0 0 2 13 
#Chair05
0 0 0 0 1 12 5 18 43 23 1 0 0 0 0 6 9 8 0 0 0 7 7 8 5 17 36 22 1 0 0 0 0 0 1 12 
#Chair04
0 0 0 0 1 13 5 17 45 22 0 0 0 0 0 6 9 7 0 0 0 8 8 6 5 14 40 22 1 0 0 0 0 1 2 14 
#Chair03
0 0 0 0 1 14 5 18 44 23 0 0 0 0 0 6 9 7 0 0 0 7 7 6 5 14 40 22 1 0 0 0 0 1 1 14 
#Chair02
0 0 0 0 2 14 4 18 38 22 1 0 0 0 0 5 11 7 0 0 0 7 10 8 4 17 39 22 2 0 0 0 0 1 3 14 
#Chair01
0 0 0 0 2 12 5 17 39 24 0 0 0 0 0 8 10 8 0 0 0 5 9 8 5 13 39 24 2 0 0 0 0 0 1 14 
#CellPhone
0 0 0 4 10 15 3 14 25 19 0 0 0 0 0 6 10 14 0 0 0 5 11 15 3 16 25 20 1 0 0 0 0 4 12 13 
#Book02
0 0 0 8 13 5 5 16 26 24 3 0 0 0 0 6 13 4 0 0 0 5 12 4 6 16 29 23 3 0 0 0 0 7 11 5 
#Book01
0 0 0 6 12 4 6 16 29 23 2 0 0 0 0 5 13 4 0 0 0 7 10 4 5 18 30 24 3 0 0 0 0 7 12 4 
