#Desk
14 37 49 65 45 23 11 5 1 0 
#Chair08
12 34 52 56 51 26 11 7 3 0 
#Chair07
12 34 53 56 51 26 11 7 3 0 
#Chair06
11 32 50 54 53 27 12 8 4 0 
#Chair05
12 35 53 56 51 25 10 7 3 0 
#Chair04
12 34 52 55 51 26 11 7 3 0 
#Chair03
12 34 51 55 51 26 11 7 3 0 
#Chair02
11 33 50 55 52 27 11 8 4 0 
#Chair01
12 33 51 55 52 27 11 8 4 0 
#CellPhone
8 33 43 46 43 31 21 15 9 3 
#Book02
14 36 47 49 44 32 19 9 2 0 
#Book01
14 36 48 50 44 31 17 8 1 0 
