#VacuumFlask03
0 0 0 0 0 0 0 0 0 0 2 6 5 5 7 10 10 10 8 9 9 7 9 6 6 9 11 14 14 13 17 20 20 8 5 2 
#VacuumFlask02
0 0 0 0 0 0 0 0 0 0 3 6 5 6 7 9 11 11 6 10 9 7 6 8 5 8 11 14 15 14 17 19 19 9 5 2 
#VacuumFlask01
0 0 0 0 0 0 0 0 0 0 3 6 5 6 8 9 10 10 7 10 9 7 6 8 5 8 10 14 16 14 16 21 20 8 5 2 
#Table
0 0 0 0 0 0 0 0 0 0 0 0 0 0 0 0 3 5 10 11 14 13 13 15 20 21 21 22 17 12 14 11 10 8 4 1 
#Desk
0 0 0 0 0 0 0 0 1 2 2 2 5 6 8 8 8 9 6 7 8 6 6 4 6 7 5 7 7 10 18 16 32 30 11 2 
#Cup09
0 0 0 1 1 2 2 2 3 3 4 5 4 5 5 17 15 22 21 11 10 9 11 8 9 10 9 9 11 5 5 4 3 5 4 8 
#Cup08
0 0 0 0 3 2 2 3 3 3 4 4 4 4 5 17 14 16 21 12 10 9 10 10 12 10 7 11 9 5 6 4 5 3 3 8 
#Cup07
0 0 0 1 1 2 2 2 3 3 4 5 4 4 5 17 15 23 21 11 10 9 11 7 9 9 9 10 11 5 5 4 3 5 4 8 
#Cup06
0 0 0 1 0 2 2 3 2 2 4 4 5 6 6 14 14 19 18 12 9 12 8 8 9 10 9 12 11 6 5 6 3 5 6 8 
#Cup05
0 0 0 0 2 1 3 2 3 4 4 4 5 4 5 16 13 20 20 13 9 12 11 8 8 9 9 9 11 5 4 4 5 2 6 8 
#Cup04
0 0 0 0 1 1 3 2 4 3 4 4 5 5 6 14 12 20 19 12 10 11 11 10 11 10 9 11 8 5 5 4 4 4 6 7 
#Cup03
0 0 0 1 1 1 1 4 4 3 3 4 5 5 7 14 11 22 21 12 9 9 10 10 9 10 7 10 8 5 5 6 5 4 6 7 
#Cup02
0 0 0 0 1 2 2 3 3 2 4 4 6 6 6 14 17 17 20 11 10 12 10 8 8 10 9 11 10 5 4 6 3 5 4 8 
#Cup012
0 0 0 0 1 1 2 3 4 3 4 4 4 6 5 17 14 17 21 10 10 10 11 7 13 9 8 11 10 4 5 6 4 5 5 7 
#Cup011
0 0 0 1 1 1 2 2 4 3 3 4 4 5 5 18 14 19 20 12 10 9 10 11 8 10 10 11 11 4 4 4 4 3 5 8 
#Cup010
0 0 0 1 2 2 3 3 3 2 4 5 5 5 7 18 13 19 19 12 11 10 9 10 9 9 8 11 11 3 5 3 4 4 4 7 
#Cup01
0 0 0 0 1 2 2 1 3 2 5 5 5 6 7 16 13 21 20 12 9 11 9 10 9 9 9 11 10 5 3 4 5 4 4 6 
#Chair08
0 0 0 1 1 1 2 6 4 7 8 9 11 12 13 11 11 10 7 7 8 8 10 13 11 11 7 8 8 6 5 5 5 7 5 3 
#Chair07
0 0 0 1 0 1 2 4 5 7 9 11 13 14 12 15 9 9 7 6 7 6 10 13 13 12 8 8 6 5 5 5 4 7 4 2 
#Chair06
0 0 0 1 1 1 3 4 4 7 9 11 13 13 12 9 8 10 7 7 8 8 12 12 14 10 7 7 6 4 6 5 6 7 5 2 
#Chair05
0 0 0 0 1 2 3 4 5 6 8 13 12 13 8 13 9 7 8 6 7 8 12 16 14 11 8 8 8 5 5 2 5 7 4 2 
#Chair04
0 0 0 1 1 1 3 4 4 7 10 13 13 14 11 9 7 10 6 6 7 8 12 13 14 11 9 7 6 4 6 6 5 6 5 2 
#Chair03
0 0 0 0 0 1 3 4 5 7 9 11 12 13 12 12 8 8 8 8 6 7 10 14 14 12 7 8 6 7 5 4 6 4 4 2 
#Chair02
0 0 0 1 1 2 2 4 5 6 9 12 14 11 10 12 8 10 8 7 8 7 12 13 15 9 10 7 6 5 5 5 4 6 5 2 
#Chair01
0 0 0 0 1 2 3 4 4 6 9 11 11 13 11 12 9 9 6 6 7 8 9 14 10 10 10 7 8 6 6 4 6 8 5 2 
