#Screen
0 0 0 6 11 7 3 15 25 37 8 0 0 0 0 4 13 9 0 0 0 5 8 4 4 14 21 25 9 0 0 0 0 4 9 5 
#Rack
0 0 0 5 12 24 8 25 17 3 0 0 0 0 0 7 10 8 0 0 0 8 9 7 8 27 19 3 0 0 0 0 0 6 13 27 
#Picture04
0 0 0 6 12 4 4 14 26 27 8 0 0 0 0 6 12 5 0 0 0 6 14 6 5 15 25 20 7 0 0 0 0 5 14 6 
#Picture03
0 0 0 7 12 10 6 19 32 11 0 0 0 0 0 6 12 7 0 0 0 6 14 8 6 19 33 12 0 0 0 0 0 8 10 9 
#Picture02
0 0 0 6 13 6 5 14 26 25 4 0 0 0 0 6 13 5 0 0 0 7 12 7 5 15 24 22 4 0 0 0 0 6 15 6 
#Picture01
0 0 0 5 16 5 4 12 26 23 4 0 0 0 0 4 14 6 0 0 0 6 16 7 4 18 25 24 4 0 0 0 0 4 14 4 
#Desk
0 0 0 12 12 6 11 28 23 3 0 0 0 0 0 11 11 5 0 0 0 12 11 5 11 28 23 3 0 0 0 0 0 11 12 8 
#Chair09
0 0 0 1 10 6 4 12 23 21 7 0 0 0 0 6 13 19 0 0 0 7 13 17 5 11 24 20 6 0 0 0 0 2 11 7 
#Chair08
0 0 0 1 10 6 4 12 23 22 7 0 0 0 0 6 13 19 0 0 0 7 13 17 5 12 24 19 6 0 0 0 0 3 11 7 
#Chair07
0 0 0 2 8 6 4 12 20 22 7 0 0 0 0 9 14 19 0 0 0 8 14 18 3 10 21 22 6 0 0 0 0 1 11 6 
#Chair06
0 0 0 3 8 6 5 12 20 23 8 0 0 0 0 9 14 18 0 0 0 8 14 18 4 11 21 22 6 0 0 0 0 1 10 6 
#Chair05
0 0 0 3 8 6 5 12 19 23 8 0 0 0 0 9 14 18 0 0 0 8 14 18 3 11 21 22 5 0 0 0 0 1 10 6 
#Chair04
0 0 0 2 8 6 5 12 20 22 7 0 0 0 0 8 14 19 0 0 0 8 14 18 3 10 21 22 6 0 0 0 0 2 11 6 
#Chair03
0 0 0 2 12 7 4 13 21 19 7 0 0 0 0 7 13 17 0 0 0 8 13 21 6 14 22 20 4 0 0 0 0 2 7 7 
#Chair02
0 0 0 2 12 7 4 13 20 19 7 0 0 0 0 7 13 18 0 0 0 8 14 20 5 14 22 20 4 0 0 0 0 3 8 7 
#Chair014
0 0 0 3 9 6 5 15 21 17 7 0 0 0 0 8 11 18 0 0 0 8 14 19 6 15 21 17 5 0 0 0 0 3 11 6 
#Chair013
0 0 0 3 9 6 5 14 21 17 7 0 0 0 0 8 11 19 0 0 0 8 15 19 6 15 20 17 5 0 0 0 0 3 12 6 
#Chair012
0 0 0 1 10 7 6 14 23 20 7 0 0 0 0 8 13 16 0 0 0 8 14 18 4 12 21 19 5 0 0 0 0 2 10 7 
#Chair011
0 0 0 1 10 7 6 14 23 20 7 0 0 0 0 9 13 16 0 0 0 8 14 18 4 12 20 18 6 0 0 0 0 2 10 7 
#Chair010
0 0 0 1 10 7 6 14 23 20 7 0 0 0 0 8 14 16 0 0 0 8 13 18 4 12 21 19 6 0 0 0 0 2 10 7 
#Chair01
0 0 0 2 10 7 5 13 21 20 6 0 0 0 0 8 12 20 0 0 0 8 15 17 5 13 18 19 6 0 0 0 0 1 9 7 
#CellingLight04
0 0 0 3 5 8 6 19 34 17 7 10 0 0 0 2 4 10 0 0 0 2 3 8 5 19 32 16 6 11 0 0 0 4 4 9 
#CellingLight03
0 0 0 2 4 9 6 21 33 16 7 13 0 0 0 3 3 9 0 0 0 1 4 8 4 20 33 17 6 9 0 0 0 3 4 9 
#CellingLight02
0 0 0 4 4 9 5 21 32 18 8 9 0 0 0 2 4 8 0 0 0 2 4 9 6 19 34 16 6 9 0 0 0 3 2 9 
#CellingLight01
0 0 0 2 4 8 4 18 34 16 9 10 0 0 0 1 4 8 0 0 0 2 4 10 5 18 35 18 8 11 0 0 0 2 4 9 
#Bonsai
0 0 0 5 5 4 3 25 44 27 20 5 0 0 0 3 5 5 0 0 0 5 4 0 3 17 27 17 7 3 0 0 0 3 4 5 
