#Screen
0 0 0 3 9 12 15 13 16 14 15 14 12 10 3 0 0 0 0 0 0 0 8 9 12 12 12 12 13 11 10 9 0 0 0 0 
#Rack
0 11 10 7 6 6 7 9 12 9 9 8 7 7 8 4 0 0 0 0 3 6 6 8 8 9 10 10 12 7 7 7 8 9 14 0 
#Picture04
0 0 0 1 10 11 13 11 12 14 15 14 12 11 1 0 0 0 0 0 0 1 14 11 12 11 14 12 11 11 11 12 2 0 0 0 
#Picture03
0 0 3 8 8 9 9 10 13 12 12 11 8 9 6 2 0 0 0 0 2 8 10 8 10 13 13 11 10 13 10 8 6 3 0 0 
#Picture02
0 0 0 4 10 10 11 11 13 13 13 12 10 9 4 0 0 0 0 0 0 4 12 10 10 13 11 13 12 11 12 12 4 0 0 0 
#Picture01
0 0 0 4 12 10 10 12 12 10 11 13 9 11 4 0 0 0 0 0 0 4 13 12 13 12 12 12 15 10 10 10 3 0 0 0 
#Desk
0 1 3 4 9 11 10 12 14 11 9 9 11 8 3 2 1 0 0 1 2 4 9 12 9 11 13 14 8 9 10 10 4 4 2 0 
#Chair09
0 0 2 3 7 5 9 7 30 16 2 3 18 11 6 2 0 0 0 0 2 6 11 19 3 3 14 30 8 6 7 8 4 1 0 0 
#Chair08
0 0 2 3 7 5 9 7 30 16 2 3 18 10 7 2 0 0 0 0 1 6 10 19 4 3 14 30 8 6 7 8 3 1 0 0 
#Chair07
0 0 2 3 4 7 8 9 28 14 1 4 21 12 6 1 1 0 0 0 1 5 12 21 3 0 13 29 9 7 6 6 3 2 0 0 
#Chair06
0 0 2 2 4 8 8 10 29 14 1 4 21 13 5 1 0 0 0 0 1 5 12 20 4 0 13 29 9 7 6 6 3 2 0 0 
#Chair05
0 0 2 3 4 8 8 10 29 14 1 4 21 12 5 1 0 0 0 0 1 5 12 20 3 0 13 30 9 7 6 6 3 2 0 0 
#Chair04
0 0 2 3 4 7 8 9 29 14 1 4 20 13 6 1 1 0 0 0 1 5 12 21 3 0 13 29 9 7 7 6 3 2 0 0 
#Chair03
0 0 3 3 6 8 6 7 31 13 2 3 18 11 6 2 0 0 0 0 1 7 11 21 4 1 16 34 6 5 6 5 2 3 0 0 
#Chair02
0 0 3 3 6 8 6 7 30 14 1 3 19 12 6 2 0 0 0 0 1 7 12 21 4 1 15 33 6 5 7 5 2 3 0 0 
#Chair014
0 0 2 2 5 8 6 8 32 14 3 3 19 10 6 1 1 0 0 0 1 6 12 21 3 1 14 33 6 6 7 7 3 2 0 0 
#Chair013
0 0 2 3 4 7 6 8 31 14 2 3 19 10 6 1 1 0 0 0 1 7 13 21 3 2 15 32 6 6 8 7 3 2 0 0 
#Chair012
0 0 2 4 6 6 7 8 31 16 2 4 20 11 5 1 0 0 0 0 1 7 13 17 3 3 13 28 8 6 6 7 4 2 0 0 
#Chair011
0 0 2 4 6 6 7 8 31 16 2 4 20 11 6 1 0 0 0 0 1 7 13 17 4 2 12 28 7 6 6 6 4 2 0 0 
#Chair010
0 0 2 4 6 6 7 8 31 17 2 4 20 11 5 1 0 0 0 0 1 7 13 17 3 3 13 28 7 6 6 7 4 2 0 0 
#Chair01
0 0 2 3 7 6 9 7 30 16 3 2 19 12 7 1 0 0 0 0 2 6 10 21 3 2 11 30 8 6 6 6 3 3 0 0 
#CellingLight04
1 0 1 2 4 7 11 17 22 20 13 9 5 4 3 2 1 0 0 1 1 2 3 4 8 14 20 20 16 11 7 4 2 1 1 0 
#CellingLight03
0 1 2 2 4 6 11 16 23 22 12 11 6 4 3 1 0 0 0 0 1 2 4 5 10 15 21 18 16 10 5 4 2 2 1 0 
#CellingLight02
0 0 1 2 4 7 11 16 22 23 14 9 5 3 2 1 1 0 0 1 1 2 4 6 8 12 21 24 16 10 6 3 1 2 1 0 
#CellingLight01
0 0 1 3 4 4 12 16 17 20 14 11 4 4 2 1 0 0 0 1 2 3 5 5 10 16 22 20 16 12 5 5 2 2 0 0 
#Bonsai
0 0 2 1 1 9 26 28 28 19 18 5 5 3 2 2 0 0 0 0 0 1 3 4 5 8 15 21 13 11 6 1 2 2 0 0 
