#Screen
0 0 0 6 13 4 3 17 26 25 4 0 0 0 0 7 12 4 0 0 0 7 12 4 6 15 28 23 5 0 0 0 0 6 12 4 
#Projector
0 0 0 1 17 0 0 7 8 36 34 8 0 0 0 0 25 18 0 0 0 0 19 11 0 4 9 21 8 0 0 0 0 0 11 8 
#Picture
0 0 0 6 11 4 6 15 23 24 8 0 0 0 0 6 13 5 0 0 0 5 13 5 4 14 26 25 8 0 0 0 0 5 14 6 
#Notebook
0 0 0 11 11 2 0 0 24 38 18 0 0 0 0 7 10 4 0 0 0 5 14 3 0 0 25 38 19 0 0 0 0 8 8 2 
#Desk
0 0 0 7 8 5 8 31 32 15 0 0 0 0 0 6 8 4 0 0 0 8 5 7 11 24 30 16 0 0 0 0 0 8 7 7 
#Clock
0 0 0 3 7 17 5 14 12 9 9 21 0 0 0 2 7 18 0 0 0 2 6 20 5 11 11 11 9 22 0 0 0 1 4 18 
#Chair09
0 0 0 3 10 8 5 12 20 19 7 0 0 0 0 8 13 19 0 0 0 7 13 18 3 12 22 20 5 0 0 0 0 2 12 8 
#Chair08
0 0 0 3 10 8 5 12 21 18 7 0 0 0 0 8 13 19 0 0 0 7 13 18 3 12 21 19 5 0 0 0 0 2 12 8 
#Chair07
0 0 0 3 9 9 4 13 21 22 6 0 0 0 0 7 10 16 0 0 0 8 13 19 3 14 21 22 7 0 0 0 0 2 10 6 
#Chair06
0 0 0 3 9 9 5 13 20 22 6 0 0 0 0 7 11 16 0 0 0 8 13 19 3 15 20 22 7 0 0 0 0 2 10 6 
#Chair05
0 0 0 3 9 9 5 13 20 22 6 0 0 0 0 7 10 16 0 0 0 8 13 19 3 15 20 22 7 0 0 0 0 2 10 6 
#Chair04
0 0 0 2 12 6 4 15 18 19 5 0 0 0 0 8 15 16 0 0 0 8 13 18 5 11 24 21 6 0 0 0 0 2 11 6 
#Chair03
0 0 0 2 11 6 4 15 19 20 5 0 0 0 0 8 15 16 0 0 0 7 13 18 5 11 24 21 6 0 0 0 0 2 12 5 
#Chair02
0 0 0 2 12 6 5 14 18 19 5 0 0 0 0 8 16 16 0 0 0 8 13 18 5 12 24 20 6 0 0 0 0 2 11 6 
#Chair016
0 0 0 2 10 6 5 15 24 19 6 0 0 0 0 8 12 18 0 0 0 9 14 18 5 13 17 18 6 0 0 0 0 3 11 7 
#Chair015
0 0 0 2 10 7 5 15 24 20 6 0 0 0 0 8 12 18 0 0 0 9 13 18 4 13 17 19 6 0 0 0 0 3 11 7 
#Chair014
0 0 0 2 10 7 4 16 24 19 6 0 0 0 0 8 12 18 0 0 0 9 14 18 4 13 17 18 6 0 0 0 0 3 11 7 
#Chair013
0 0 0 3 9 6 5 15 22 22 7 0 0 0 0 8 11 20 0 0 0 8 13 13 4 12 20 20 6 0 0 0 0 2 11 6 
#Chair012
0 0 0 3 9 6 5 16 21 22 7 0 0 0 0 8 11 19 0 0 0 9 13 14 4 13 19 21 6 0 0 0 0 2 11 6 
#Chair011
0 0 0 2 9 6 6 15 22 22 7 0 0 0 0 8 11 20 0 0 0 8 13 14 3 12 20 20 6 0 0 0 0 2 11 6 
#Chair010
0 0 0 3 12 8 4 14 23 21 5 0 0 0 0 8 14 15 0 0 0 8 13 15 5 11 20 19 5 0 0 0 0 2 13 6 
#Chair01
0 0 0 3 12 8 4 14 23 21 5 0 0 0 0 8 13 15 0 0 0 8 12 14 5 12 20 19 5 0 0 0 0 2 13 7 
#CellingLigth09
0 0 0 0 24 29 0 0 59 75 2 0 0 0 0 0 32 27 0 0 0 0 0 1 0 0 0 0 0 0 0 0 0 0 0 2 
#CellingLigth08
0 0 0 3 14 12 2 12 14 13 26 1 0 0 0 2 13 9 0 0 0 3 14 10 1 12 15 13 27 1 0 0 0 4 12 12 
#CellingLigth07
0 0 0 3 13 8 1 13 13 13 24 2 0 0 0 3 13 11 0 0 0 3 13 10 1 14 17 13 28 1 0 0 0 4 13 10 
#CellingLigth06
0 0 0 3 13 8 1 13 13 13 24 2 0 0 0 3 13 11 0 0 0 3 12 10 2 14 17 14 29 1 0 0 0 4 13 10 
#CellingLigth05
0 0 0 3 13 8 1 13 14 13 24 1 0 0 0 3 13 11 0 0 0 3 12 10 1 14 17 14 28 1 0 0 0 4 13 10 
#CellingLigth04
0 0 0 3 13 8 1 13 13 13 24 2 0 0 0 3 13 11 0 0 0 3 12 10 1 14 17 14 28 1 0 0 0 4 13 10 
#CellingLigth03
0 0 0 3 14 9 1 14 15 13 28 1 0 0 0 3 14 10 0 0 0 3 17 7 1 9 13 15 24 2 0 0 0 4 11 12 
#CellingLigth02
0 0 0 3 14 9 1 14 16 13 28 1 0 0 0 3 13 10 0 0 0 2 17 7 2 9 13 15 25 2 0 0 0 3 11 12 
#CellingLigth012
0 0 0 0 25 30 0 0 57 77 1 0 0 0 0 0 31 29 0 0 0 0 0 1 0 0 0 0 0 0 0 0 0 0 0 1 
#CellingLigth011
0 0 0 0 25 30 0 0 57 76 1 0 0 0 0 0 31 29 0 0 0 0 0 1 0 0 0 0 0 0 0 0 0 0 0 1 
#CellingLigth010
0 0 0 0 26 30 0 0 59 74 2 0 0 0 0 0 29 28 0 0 0 0 0 1 0 0 0 0 0 0 0 0 0 0 0 2 
#CellingLigth01
0 0 0 3 14 9 1 12 13 12 26 1 0 0 0 4 14 11 0 0 0 2 15 11 2 12 16 11 25 2 0 0 0 3 14 11 
#Cabinet
0 0 0 6 7 13 2 21 19 6 0 0 0 0 0 6 7 13 0 0 0 8 14 15 8 24 32 9 0 0 0 0 0 9 12 14 
#Book
0 0 0 4 24 8 1 7 16 32 19 1 0 0 0 5 13 5 0 0 0 4 11 2 1 7 17 27 9 0 0 0 0 4 23 4 
#Ashtray
0 0 0 4 10 14 0 5 11 24 16 18 0 0 0 3 9 14 0 0 0 3 8 13 0 3 8 20 21 15 0 0 0 3 10 13 
