#Screen
14 35 46 49 45 34 20 8 1 0 
#Projector
7 20 32 47 53 46 25 17 5 0 
#Picture
13 33 44 48 44 36 22 9 2 0 
#Notebook
11 31 43 49 50 39 21 6 0 0 
#Desk
26 60 50 35 33 22 16 7 2 0 
#Clock
9 21 30 37 42 36 28 24 18 6 
#Chair09
9 22 38 52 53 37 21 14 5 0 
#Chair08
9 22 38 52 53 36 22 14 5 0 
#Chair07
9 22 39 53 53 38 20 12 5 0 
#Chair06
9 22 39 53 53 38 20 12 4 0 
#Chair05
9 22 39 53 53 38 21 12 4 0 
#Chair04
9 23 39 53 54 36 21 12 4 0 
#Chair03
9 23 39 54 55 36 20 12 4 0 
#Chair02
9 23 39 53 54 36 21 13 4 0 
#Chair016
9 23 39 53 53 36 20 13 4 0 
#Chair015
9 22 39 53 53 36 20 13 4 0 
#Chair014
9 23 39 53 53 36 20 13 4 0 
#Chair013
9 23 41 54 53 36 20 12 4 0 
#Chair012
9 24 41 54 53 36 20 12 4 0 
#Chair011
9 23 41 54 53 36 20 12 4 0 
#Chair010
9 23 40 53 52 36 21 13 4 0 
#Chair01
9 24 40 54 52 36 20 12 4 0 
#CellingLigth09
38 53 42 35 29 23 16 11 5 0 
#CellingLigth08
7 24 37 43 43 36 36 20 5 0 
#CellingLigth07
7 24 38 44 44 35 34 19 5 0 
#CellingLigth06
7 24 38 44 44 35 35 19 5 0 
#CellingLigth05
7 24 39 44 44 35 34 18 5 0 
#CellingLigth04
7 24 38 44 44 35 34 19 5 0 
#CellingLigth03
7 24 37 43 43 36 36 20 5 0 
#CellingLigth02
7 24 37 43 43 36 36 20 5 0 
#CellingLigth012
39 53 42 35 29 23 16 10 4 0 
#CellingLigth011
39 53 41 35 29 23 17 11 4 0 
#CellingLigth010
38 53 41 35 29 23 17 11 5 0 
#CellingLigth01
7 24 38 42 43 36 36 20 6 0 
#Cabinet
9 42 55 43 34 24 19 14 9 3 
#Book
4 20 40 50 51 42 29 13 1 0 
#Ashtray
5 20 32 35 37 38 37 29 15 3 
