#Desk
0 0 0 6 13 13 5 19 28 11 0 0 0 0 0 7 13 11 0 0 0 6 13 11 3 17 29 11 0 0 0 0 0 6 13 13 
#Chair08
0 0 0 0 2 13 4 16 42 21 1 0 0 0 0 6 10 7 0 0 0 7 8 7 5 17 39 24 1 0 0 0 0 0 2 13 
#Chair07
0 0 0 0 2 14 4 16 43 22 1 0 0 0 0 7 10 7 0 0 0 7 7 7 5 17 39 23 1 0 0 0 0 0 2 13 
#Chair06
0 0 0 0 2 12 4 16 43 25 0 0 0 0 0 7 10 8 0 0 0 8 8 7 4 16 37 22 2 0 0 0 0 1 1 13 
#Chair05
0 0 0 0 2 12 4 16 43 25 0 0 0 0 0 7 10 8 0 0 0 8 8 7 4 17 37 21 2 0 0 0 0 1 2 12 
#Chair04
0 0 0 1 2 11 4 15 40 23 0 0 0 0 0 6 8 8 0 0 0 8 7 8 4 19 40 24 1 0 0 0 0 0 2 13 
#Chair03
0 0 0 1 2 12 4 15 39 23 0 0 0 0 0 6 8 8 0 0 0 7 7 8 4 19 41 24 1 0 0 0 0 0 2 13 
#Chair02
0 0 0 0 1 15 3 18 38 22 0 0 0 0 0 7 8 8 0 0 0 8 8 7 6 15 43 22 2 0 0 0 0 0 2 11 
#Chair01
0 0 0 1 2 11 6 14 43 22 1 0 0 0 0 7 9 8 0 0 0 6 8 7 4 17 41 24 1 0 0 0 0 0 1 14 
