#Desk
0 0 1 1 2 3 4 5 5 6 6 8 9 8 9 11 8 10 8 8 7 7 7 7 6 8 9 10 6 13 12 11 8 6 6 4 
#Chair08
0 0 0 2 2 4 3 3 5 7 6 7 8 12 14 18 14 13 12 11 10 11 9 6 6 4 3 3 3 4 6 7 8 8 7 3 
#Chair07
0 0 0 2 2 4 3 3 4 7 6 7 7 13 14 18 14 13 12 11 9 11 9 6 6 4 3 3 3 4 6 7 8 8 7 3 
#Chair06
0 0 0 1 2 3 3 4 6 5 6 6 8 14 14 13 16 13 14 9 11 10 10 9 5 5 3 3 3 3 5 8 10 6 6 3 
#Chair05
0 0 0 2 2 3 4 4 6 5 6 6 8 14 14 13 16 13 14 9 11 11 10 9 5 5 3 3 3 2 5 8 11 6 6 3 
#Chair04
0 0 1 1 3 3 4 4 5 6 6 6 9 15 13 15 13 14 10 11 11 11 10 9 4 4 2 4 3 3 4 8 10 7 7 3 
#Chair03
0 0 1 1 3 3 4 4 5 6 7 7 9 15 14 15 13 13 10 12 11 11 10 8 4 4 3 3 2 3 5 8 10 7 7 3 
#Chair02
0 0 1 2 2 3 4 5 6 6 6 4 7 14 16 15 14 13 12 11 8 9 9 10 4 4 2 4 3 3 5 10 10 5 7 3 
#Chair01
0 0 1 1 3 4 3 5 4 5 7 4 9 13 14 16 14 17 13 9 11 10 8 7 7 3 3 2 4 3 4 8 12 6 5 4 
