#Desk
12 35 49 47 36 27 21 16 8 0 
#Chair08
11 33 51 56 52 27 11 7 3 0 
#Chair07
11 33 51 56 52 27 11 7 3 0 
#Chair06
12 34 51 56 51 26 11 8 3 0 
#Chair05
11 34 52 56 51 26 11 8 3 0 
#Chair04
11 33 51 56 52 26 11 7 3 0 
#Chair03
11 33 51 56 52 27 11 7 3 0 
#Chair02
12 34 52 56 51 26 11 7 3 0 
#Chair01
11 33 51 56 52 26 11 7 3 0 
