#Desk
0 0 2 10 12 8 10 12 11 11 8 9 9 10 9 2 0 0 0 0 2 8 10 9 10 9 9 11 10 9 9 11 9 3 0 0 
#Chair08
0 0 0 3 5 7 1 4 23 24 18 14 7 7 5 2 1 0 0 1 3 4 5 8 13 18 24 22 6 1 5 6 4 0 0 0 
#Chair07
0 0 0 3 5 7 1 4 23 24 18 14 7 7 5 3 1 0 0 1 3 4 5 8 13 18 24 22 6 1 4 6 4 0 0 0 
#Chair06
0 0 0 4 5 4 2 4 19 27 19 16 9 7 3 5 1 0 0 0 3 5 5 8 13 17 23 20 5 2 6 5 3 1 0 0 
#Chair05
0 0 0 4 5 5 2 4 20 27 19 17 8 7 3 5 1 0 0 0 3 5 6 8 13 17 23 20 5 2 6 5 2 1 0 0 
#Chair04
0 0 0 3 4 6 2 4 23 21 19 13 7 6 4 4 0 0 0 1 4 5 5 9 14 19 25 23 5 2 4 5 4 0 0 0 
#Chair03
0 0 0 3 4 6 2 4 23 21 19 13 7 6 4 4 0 0 0 0 3 5 4 8 14 18 26 24 5 2 5 5 4 0 0 0 
#Chair02
0 0 0 4 7 5 2 6 19 22 18 14 8 6 4 3 2 0 0 0 3 4 6 8 15 16 28 22 4 2 7 4 2 1 0 0 
#Chair01
0 0 0 3 5 5 2 5 20 25 19 14 8 7 4 3 1 0 0 0 4 4 5 7 14 18 24 24 5 2 5 4 4 1 0 0 
