#Desk
10 25 39 54 51 34 23 13 3 0 
#Chair08
10 26 44 58 56 36 15 5 1 0 
#Chair07
10 27 44 58 55 35 15 5 1 0 
#Chair06
10 27 44 58 56 36 15 5 1 0 
#Chair05
10 26 44 58 56 36 16 5 1 0 
#Chair04
10 26 43 58 56 36 15 5 1 0 
#Chair03
10 26 43 58 57 36 15 5 1 0 
#Chair02
10 27 45 59 55 34 15 5 1 0 
#Chair01
10 26 43 57 57 37 16 5 1 0 
