#Desk
0 0 0 3 11 20 8 8 16 11 7 12 16 5 6 0 0 0 0 0 0 4 6 14 12 9 12 17 8 9 16 8 6 0 0 0 
#Chair08
0 0 0 0 2 3 6 19 31 16 12 12 6 5 8 4 0 0 0 0 3 6 6 7 12 11 14 30 17 5 4 2 0 0 0 0 
#Chair07
0 0 0 0 2 5 6 16 29 19 9 14 5 7 7 3 0 0 0 0 3 6 5 5 11 12 16 33 17 6 4 1 0 0 0 0 
#Chair06
0 0 0 0 2 4 6 17 29 17 12 13 6 7 7 3 0 0 0 0 3 5 9 6 13 14 16 28 16 6 4 1 0 0 0 0 
#Chair05
0 0 0 0 1 4 6 19 28 16 10 12 7 8 6 4 0 0 0 0 3 6 5 5 12 11 17 27 18 8 4 2 1 0 0 0 
#Chair04
0 0 1 1 3 5 4 16 28 16 13 11 6 6 7 2 0 0 0 0 3 6 7 6 13 11 17 30 18 6 5 3 0 0 0 0 
#Chair03
0 0 0 0 2 3 7 17 29 19 12 12 6 6 6 3 0 0 0 0 3 6 6 6 14 12 16 27 18 6 4 3 1 0 0 0 
#Chair02
0 0 0 1 1 6 5 18 29 17 11 11 6 6 6 3 0 0 0 0 3 6 6 6 11 9 20 31 17 7 3 2 0 0 0 0 
#Chair01
0 0 0 0 2 4 6 19 28 16 11 13 7 5 7 3 0 0 0 0 3 6 6 5 13 12 16 30 16 6 4 2 0 1 0 0 
