#Desk
0 0 0 0 0 0 0 0 0 0 0 2 6 16 12 12 13 10 11 10 10 10 14 13 16 17 15 12 8 8 6 6 7 6 2 1 
#Chair08
0 0 0 0 1 2 3 4 7 4 6 6 9 8 9 11 12 13 10 12 17 13 11 12 10 10 7 4 4 4 6 5 6 6 4 2 
#Chair07
0 0 0 1 2 3 4 4 6 6 5 5 8 6 11 11 12 12 12 13 13 15 9 11 10 11 7 5 5 4 5 4 7 6 3 2 
#Chair06
0 0 1 0 1 1 5 4 5 4 5 6 7 7 8 11 11 15 11 15 13 15 12 11 12 9 6 7 4 4 5 4 7 6 4 2 
#Chair05
0 0 1 1 2 1 4 5 6 3 5 7 8 7 9 11 11 12 13 12 13 15 11 13 11 11 6 5 6 2 4 5 5 8 4 2 
#Chair04
0 0 0 1 1 2 3 3 7 3 5 7 9 8 8 9 10 13 10 14 12 16 13 13 9 11 6 5 6 5 3 5 6 6 3 3 
#Chair03
0 0 0 0 1 2 3 4 5 5 4 7 7 10 9 11 10 14 11 13 13 16 12 11 11 9 6 4 4 4 4 5 8 7 4 2 
#Chair02
0 0 0 1 2 2 5 5 6 7 6 7 7 6 9 11 13 13 11 12 12 13 11 10 10 7 6 6 5 6 3 5 7 6 4 2 
#Chair01
0 0 0 1 1 3 4 4 6 3 5 6 6 7 8 11 12 13 12 13 13 16 12 12 13 9 7 6 6 4 3 6 7 6 3 2 
