#TV03
0 0 0 8 9 9 11 12 10 13 13 10 9 11 9 0 0 0 0 0 0 6 8 12 10 12 11 11 11 12 12 8 7 0 0 0 
#TV02
0 0 0 8 9 12 10 15 14 13 11 10 11 7 7 0 0 0 0 0 0 6 11 10 10 11 13 10 13 11 9 8 6 0 0 0 
#TV01
0 0 0 7 9 10 12 14 14 12 10 11 11 9 8 0 0 0 0 0 0 7 8 11 9 13 12 12 11 9 10 9 7 0 0 0 
#Desk
0 1 2 10 15 7 5 8 16 13 6 6 8 12 7 2 0 0 0 1 2 7 13 12 5 6 14 16 8 7 6 12 10 3 1 0 
#Chair09
0 0 1 2 3 14 13 12 29 9 18 4 4 3 2 3 1 0 0 1 3 2 4 6 4 19 9 28 15 13 11 4 3 0 0 0 
#Chair08
0 0 0 2 3 13 13 12 29 13 20 5 4 3 2 3 1 0 0 1 3 3 4 4 5 16 9 27 12 14 12 3 2 1 0 0 
#Chair07
0 0 0 2 4 11 13 14 29 10 17 3 5 4 2 2 1 0 0 0 3 3 3 4 4 19 9 29 14 15 11 5 2 0 0 0 
#Chair06
0 0 1 2 4 10 13 14 33 9 18 5 4 3 2 3 1 0 0 0 2 2 3 4 5 19 11 26 14 14 12 4 2 0 0 0 
#Chair05
0 0 1 3 4 12 12 12 31 12 19 4 4 3 3 2 0 0 0 1 2 3 3 4 4 17 9 29 14 14 10 4 3 1 0 0 
#Chair04
0 1 0 3 5 10 16 13 27 10 19 3 5 4 3 3 1 0 0 0 2 1 3 4 6 18 10 27 15 12 10 4 3 1 0 0 
#Chair03
0 0 0 3 4 12 12 13 29 9 18 4 6 4 3 4 1 0 0 0 2 3 2 5 4 19 11 26 13 14 10 5 3 0 0 0 
#Chair02
0 0 0 3 5 12 12 13 30 8 19 4 6 4 3 3 1 0 0 0 2 3 2 5 4 19 11 27 12 14 10 5 3 1 0 0 
#Chair013
0 0 0 2 5 12 13 11 30 7 18 5 5 3 3 3 1 0 0 1 4 2 3 4 4 21 9 29 14 14 11 4 2 0 0 0 
#Chair012
0 0 1 2 5 11 12 14 30 10 19 4 4 3 2 4 1 0 0 1 3 3 3 4 4 20 9 27 14 13 12 6 3 0 0 0 
#Chair011
0 0 1 2 4 11 14 11 33 9 18 5 4 3 3 3 1 0 0 1 3 3 3 3 5 17 9 27 14 13 12 4 1 0 0 0 
#Chair010
0 0 1 2 5 12 11 13 29 10 21 4 4 4 2 4 1 0 0 2 5 3 3 3 4 18 11 24 14 14 12 4 2 0 0 0 
#Chair01
0 0 1 2 5 10 13 14 27 10 19 4 5 3 4 3 1 0 0 0 4 3 3 4 5 19 11 28 13 11 13 4 2 1 0 0 
#Cabinet05
0 0 0 3 12 14 16 19 24 17 17 17 15 22 1 0 0 0 0 0 0 10 6 4 5 6 7 6 7 7 8 3 0 0 0 0 
#Cabinet04
0 0 0 0 11 16 21 20 22 22 18 19 16 14 0 0 0 0 0 0 0 0 4 8 5 7 7 8 7 6 7 6 0 0 0 0 
#Cabinet03
0 0 0 2 10 16 17 20 19 25 22 16 15 15 2 0 0 0 0 0 0 1 6 6 6 8 6 7 8 6 8 5 0 0 0 0 
#Cabinet02
0 0 9 8 9 12 12 15 15 16 16 12 12 10 7 7 0 0 0 0 7 6 2 5 5 6 5 6 7 7 6 4 9 7 0 0 
#Cabinet01
0 0 8 8 9 11 16 15 14 16 13 12 9 9 7 11 0 0 0 0 7 8 3 4 4 6 7 7 5 6 6 6 8 6 0 0 
#Bookshelf06
0 0 0 10 3 13 4 14 5 16 8 8 7 6 11 0 0 0 0 0 0 12 7 8 10 11 15 9 19 9 18 10 11 0 0 0 
#Bookshelf05
0 0 0 10 7 15 7 16 8 12 10 9 9 8 11 0 0 0 0 0 0 9 9 10 11 8 12 11 16 8 12 7 11 0 0 0 
#Bookshelf04
0 0 0 5 8 16 9 18 9 14 12 7 9 8 10 0 0 0 0 0 0 6 9 10 10 13 14 9 15 8 13 3 8 0 0 0 
#Bookshelf03
0 0 0 10 5 14 6 13 6 13 11 9 8 11 8 0 0 0 0 0 0 8 8 10 11 13 11 11 18 8 15 10 7 0 0 0 
#Bookshelf02
0 0 0 0 13 16 8 17 9 14 10 7 7 10 6 0 0 0 0 0 0 1 16 10 11 13 17 9 14 7 13 11 5 0 0 0 
#Bookshelf01
0 0 0 3 10 13 7 16 7 16 9 10 8 11 6 0 0 0 0 0 0 6 11 10 10 12 15 11 18 9 12 10 4 0 0 0 
