#TV03
0 0 0 4 14 8 3 14 28 22 2 0 0 0 0 5 16 8 0 0 0 7 13 6 3 18 25 21 2 0 0 0 0 6 13 7 
#TV02
0 0 0 6 15 7 3 18 27 23 3 0 0 0 0 5 13 6 0 0 0 6 13 8 3 14 28 21 2 0 0 0 0 6 11 7 
#TV01
0 0 0 6 12 7 6 19 26 22 1 0 0 0 0 5 13 9 0 0 0 7 12 7 5 19 27 16 0 0 0 0 0 6 12 7 
#Desk
0 0 0 8 18 9 12 20 19 4 0 0 0 0 0 7 17 5 0 0 0 11 20 6 12 20 20 4 0 0 0 0 0 6 16 10 
#Chair09
0 0 0 8 6 8 2 18 47 16 1 0 0 0 0 2 5 7 0 0 0 4 5 7 1 19 49 19 1 0 0 0 0 5 5 8 
#Chair08
0 0 0 6 6 9 2 19 53 18 0 0 0 0 0 2 6 7 0 0 0 3 5 7 3 16 48 16 0 0 0 0 0 6 5 8 
#Chair07
0 0 0 6 6 7 2 18 49 17 1 1 0 0 0 3 5 6 0 0 0 2 5 7 2 18 50 19 2 0 0 0 0 6 8 6 
#Chair06
0 0 0 5 6 9 2 19 55 16 1 0 0 0 0 3 5 6 0 0 0 3 4 6 2 17 50 19 1 0 0 0 0 6 6 6 
#Chair05
0 0 0 6 6 9 2 21 50 17 1 0 0 0 0 2 5 6 0 0 0 3 5 6 2 17 52 15 1 0 0 0 0 5 6 8 
#Chair04
0 0 0 6 7 6 1 20 50 16 1 0 0 0 0 3 6 8 0 0 0 3 3 6 2 20 49 17 0 0 0 0 0 5 6 8 
#Chair03
0 0 0 6 8 7 2 18 47 17 1 0 0 0 0 4 5 9 0 0 0 3 4 6 1 18 51 16 1 0 0 0 0 3 7 10 
#Chair02
0 0 0 6 8 7 2 18 48 18 2 0 0 0 0 4 5 8 0 0 0 3 4 6 1 18 51 17 1 0 0 0 0 4 6 10 
#Chair013
0 0 0 7 5 8 1 16 51 15 1 0 0 0 0 3 5 7 0 0 0 3 4 8 2 19 50 18 2 0 0 0 0 6 5 7 
#Chair012
0 0 0 6 6 8 1 21 50 16 0 0 0 0 0 3 4 8 0 0 0 3 6 6 1 19 47 18 1 0 0 0 0 6 7 8 
#Chair011
0 0 0 5 6 8 2 17 51 18 1 1 0 0 0 3 5 8 0 0 0 2 6 8 1 18 50 15 1 0 0 0 0 6 6 8 
#Chair010
0 0 0 5 7 8 1 19 49 17 1 0 0 0 0 2 6 7 0 0 0 1 4 10 1 20 45 19 0 0 0 0 0 5 8 6 
#Chair01
0 0 0 5 5 8 1 16 50 18 1 0 0 0 0 3 4 8 0 0 0 2 5 8 2 19 51 15 1 0 0 0 0 5 7 9 
#Cabinet05
0 0 0 6 16 7 0 12 37 43 18 0 0 0 0 3 20 15 0 0 0 2 9 8 0 7 14 13 3 0 0 0 0 4 6 2 
#Cabinet04
0 0 0 3 14 9 0 13 39 51 21 0 0 0 0 4 16 9 0 0 0 3 6 3 0 8 18 15 2 0 0 0 0 3 6 3 
#Cabinet03
0 0 0 5 16 7 0 14 41 52 12 0 0 0 0 4 19 9 0 0 0 2 8 3 0 9 16 14 2 0 0 0 0 4 8 1 
#Cabinet02
0 0 0 8 14 18 0 25 45 16 0 0 0 0 0 8 16 14 0 0 0 5 4 13 2 16 15 3 0 0 0 0 0 6 6 14 
#Cabinet01
0 0 0 6 14 17 0 22 47 19 0 0 0 0 0 6 14 17 0 0 0 4 5 14 3 17 12 3 0 0 0 0 0 5 7 14 
#Bookshelf06
0 0 0 9 12 5 3 17 22 13 1 0 0 0 0 4 12 9 0 0 0 3 15 9 3 16 23 27 5 0 0 0 0 10 17 10 
#Bookshelf05
0 0 0 9 12 11 1 13 18 23 6 0 0 0 0 2 14 12 0 0 0 5 11 12 2 13 22 24 5 0 0 0 0 7 14 9 
#Bookshelf04
0 0 0 10 13 7 3 15 22 23 6 0 0 0 0 3 13 11 0 0 0 5 11 10 1 16 20 26 5 0 0 0 0 7 9 8 
#Bookshelf03
0 0 0 8 12 8 1 13 17 22 6 0 0 0 0 3 13 11 0 0 0 2 14 10 2 13 20 31 6 0 0 0 0 8 15 9 
#Bookshelf02
0 0 0 10 13 7 3 13 19 23 7 0 0 0 0 1 12 9 0 0 0 4 14 9 2 16 24 22 8 0 0 0 0 6 15 7 
#Bookshelf01
0 0 0 8 12 6 2 14 18 23 8 0 0 0 0 4 10 11 0 0 0 3 14 10 2 16 23 28 8 0 0 0 0 7 13 8 
