#WallLamp02
0 0 0 1 1 2 2 3 6 4 8 7 8 8 9 11 11 14 15 14 14 12 12 11 9 7 7 9 7 8 6 4 4 3 1 0 
#WallLamp01
0 0 0 0 0 1 2 5 5 6 7 10 8 9 10 11 12 12 14 12 14 12 11 11 9 10 8 8 7 7 9 3 2 2 1 0 
#Screen
0 0 1 2 3 4 4 5 6 5 7 5 6 6 7 12 10 12 12 11 13 10 10 9 11 13 12 10 11 7 6 4 3 1 1 0 
#Projector
0 0 0 0 0 0 0 0 1 2 3 3 4 4 5 4 6 7 4 5 5 6 5 9 18 13 12 14 20 24 15 13 9 11 14 7 
#Desk
0 0 0 0 0 0 0 0 0 4 5 5 4 7 10 13 16 14 14 14 9 12 9 11 9 10 17 15 11 11 8 6 4 2 0 0 
#Chair05
0 0 0 0 0 0 0 0 0 3 6 6 7 9 12 18 16 10 9 9 7 6 2 6 4 5 4 4 4 11 18 24 22 13 6 2 
#Chair04
0 0 0 0 0 0 0 0 0 2 6 8 8 9 12 17 11 11 9 9 4 3 4 5 4 4 6 5 4 10 22 23 22 17 7 1 
#Chair03
0 0 0 0 0 0 0 0 0 2 4 7 7 7 14 17 15 12 9 7 4 4 5 5 5 6 4 4 5 10 20 22 23 16 7 1 
#Chair02
0 0 0 0 0 0 0 0 0 3 5 7 7 10 13 17 14 10 11 7 4 3 5 3 4 4 4 3 4 11 21 22 22 15 8 2 
#Chair01
0 0 0 0 0 0 0 0 0 2 4 7 7 8 15 16 13 10 9 7 4 6 5 4 5 6 4 4 5 13 19 24 22 16 6 2 
