#WallLamp02
0 0 0 6 2 1 3 15 30 32 12 1 0 0 0 3 9 8 0 0 0 3 9 8 3 17 33 29 12 0 0 0 0 6 3 1 
#WallLamp01
0 0 0 5 2 1 2 19 33 31 12 0 0 0 0 3 9 7 0 0 0 3 11 8 2 18 30 29 11 1 0 0 0 4 3 1 
#Screen
0 0 0 6 15 4 6 17 28 21 2 0 0 0 0 7 15 4 0 0 0 5 14 4 6 17 28 21 4 0 0 0 0 5 14 4 
#Projector
0 0 0 1 12 16 0 6 16 14 25 0 0 0 0 1 10 16 0 0 0 2 11 18 0 4 16 15 30 1 0 0 0 2 13 16 
#Desk
0 0 0 3 16 7 0 8 33 30 1 0 0 0 0 3 20 4 0 0 0 2 16 5 0 7 35 28 0 0 0 0 0 3 20 6 
#Chair05
0 0 0 4 15 22 0 0 14 14 0 0 0 0 0 0 0 6 0 0 0 11 12 3 0 16 59 11 0 0 0 0 0 0 5 57 
#Chair04
0 0 0 5 16 22 0 0 13 12 0 0 0 0 0 0 0 6 0 0 0 9 11 4 0 17 56 10 0 0 0 0 0 0 6 61 
#Chair03
0 0 0 4 16 22 0 0 15 9 0 0 0 0 0 0 0 6 0 0 0 11 14 3 0 14 58 11 0 0 0 0 0 0 6 59 
#Chair02
0 0 0 4 14 21 0 0 13 11 0 0 0 0 0 0 0 6 0 0 0 8 13 3 0 16 60 12 0 0 0 0 0 0 6 62 
#Chair01
0 0 0 5 18 23 0 0 12 11 0 0 0 0 0 0 0 6 0 0 0 11 14 4 0 14 59 10 0 0 0 0 0 0 7 56 
