#WallLight05
0 0 0 0 9 35 11 5 6 7 6 15 33 9 0 0 0 0 0 0 0 8 13 11 15 6 2 1 3 17 10 13 10 0 0 0 
#WallLight04
0 0 0 0 9 34 11 6 6 7 6 15 33 10 0 0 0 0 0 0 0 9 12 11 15 6 2 1 3 16 10 14 11 0 0 0 
#WallLight03
0 0 0 0 9 33 8 6 6 8 7 13 40 8 0 0 0 0 0 0 0 8 14 11 16 5 1 1 3 14 12 13 8 0 0 0 
#WallLight02
0 0 0 0 10 32 8 6 6 8 7 12 40 8 0 0 0 0 0 0 0 9 15 11 15 5 1 1 3 15 12 12 8 0 0 0 
#WallLight01
0 0 0 0 9 33 8 6 6 8 7 12 39 8 0 0 0 0 0 0 0 8 14 11 16 5 1 1 4 15 11 13 8 0 0 0 
#Table02
0 0 0 3 24 7 8 7 9 9 7 8 9 20 12 0 0 0 0 0 0 6 26 7 6 8 9 8 8 7 8 17 11 0 0 0 
#Table01
0 0 0 0 0 24 16 9 8 11 11 9 21 13 0 0 0 0 0 0 0 0 0 20 21 10 11 11 8 10 22 13 0 0 0 0 
#Sofa02
0 0 0 5 8 7 13 15 20 15 12 10 10 2 0 0 0 0 0 0 0 1 2 9 12 13 19 19 15 13 8 8 4 1 0 0 
#Sofa01
0 0 2 4 6 10 13 17 18 18 13 13 9 3 1 0 0 0 0 0 0 0 2 11 9 11 16 18 13 15 10 7 4 1 0 0 
#Screen
0 0 0 0 7 12 13 15 13 15 16 18 14 8 0 0 0 0 0 0 0 0 6 13 12 13 13 13 12 13 11 7 0 0 0 0 
#Picture
0 0 0 10 6 8 11 12 11 14 12 11 9 8 11 0 0 0 0 0 0 11 8 10 10 11 9 10 12 12 9 7 12 0 0 0 
#Lamp
0 0 3 7 8 13 14 32 1 2 1 3 3 6 21 4 0 0 0 0 4 23 5 2 3 1 1 1 36 16 12 9 9 3 0 0 
#Desk
0 1 2 4 4 18 43 19 5 6 12 35 22 3 1 1 0 0 0 1 3 3 5 7 7 6 8 6 6 6 3 2 2 1 0 0 
#Chair09
0 0 1 4 10 12 13 20 22 16 14 7 2 1 0 0 0 0 0 0 0 0 1 2 9 12 17 18 21 13 13 10 5 0 0 0 
#Chair08
0 0 1 8 10 13 13 19 18 18 15 7 1 1 0 0 0 0 0 0 0 0 0 1 8 14 18 24 20 11 12 10 4 0 0 0 
#Chair07
0 0 0 7 9 14 11 18 21 16 15 7 1 1 0 0 0 0 0 0 0 0 1 1 10 14 17 21 20 13 12 10 5 0 0 0 
#Chair06
0 0 0 5 10 14 11 22 21 18 14 8 1 0 0 0 0 0 0 0 0 0 1 1 9 13 16 22 19 14 10 9 6 0 0 0 
#Chair05
0 0 0 6 11 13 13 20 21 19 13 8 2 1 0 0 0 0 0 0 0 0 1 2 8 15 15 19 20 12 13 8 5 0 0 0 
#Chair04
0 0 1 6 9 15 13 20 21 18 14 7 1 0 0 0 0 0 0 0 0 0 1 1 6 14 16 21 21 12 14 9 5 0 0 0 
#Chair03
0 0 0 7 9 12 14 21 19 18 15 7 1 0 0 0 0 0 0 0 0 0 0 1 8 15 15 22 20 12 13 8 6 0 0 0 
#Chair02
0 0 1 5 8 11 12 22 24 17 12 7 2 1 0 0 0 0 0 0 0 0 1 1 9 12 17 21 23 13 13 8 5 0 0 0 
#Chair010
0 0 0 6 10 15 13 24 18 16 12 9 2 2 0 0 0 0 0 0 0 0 0 2 6 12 17 17 20 13 16 11 5 0 0 0 
#Chair01
0 0 0 6 10 14 12 21 21 16 12 8 1 0 0 0 0 0 0 0 0 0 1 1 6 13 17 20 22 14 12 10 6 0 0 0 
#CellingLight
0 0 0 0 0 6 11 24 19 9 25 11 0 0 4 5 1 0 0 2 3 0 0 0 18 17 11 31 23 16 8 0 0 0 0 0 
